compound	split
kenacideva	kenaci + eva
caparaṃ	ca + paraṃ
sakideva	saki + eva
āmāti	āma + iti
tyāhaṃ	te + ahaṃ
vātipi	vā + iti + api
sohaṃ	so + ahaṃ
teyeva	te + eva
nāhaṃ	na + ahaṃ
sopissa	so + api + assa
yepissa	ye + api + assa
somhi	so + amhi
atoti	ato + iti
tepi	te + api
svāyaṃ	so + ayaṃ
svāssa	so + assa
yeme	ye + ime
yepi	ye + api
sāva	sā + eva
isīti	isi + iti
midhekaccaṃ	m + idha + ekaccaṃ
midhekaccaṃ	m + idhekaccaṃ
soyeva	so + eva
teti	te + iti
sopi	so + api
vātiādikaṃ	vā + iti + ādikaṃ
vātiādimāha	vā + iti + ādiṃ + āha
vātiādīni	vā + iti + ādīni
sāpi	sā + api
sāssa	sā + assa
tāyapi	tāya + api
tāyeva	tāya + eva
tāyevappāhāratāya	tāya + eva + appāhāratāya
tāyevāti	tāya + eva + iti
yantīti	yanti + iti
attanti	attaṃ + iti
kāyantīti	kāyanti + iti
yvāyanti	yo + ayaṃ + iti
yāyantipi	yā + ayaṃ + iti + api
yāyantīti	yāyanti + iti
āyantīti	āyanti + iti
ayatīti	ayati + iti
dentoti	dento + iti
ayoti	ayo + iti
kamettha	kaṃ + ettha
kaṃsi	kaṃ + asi
kamuddiseyyaṃ	kaṃ + uddiseyyaṃ
kañca	kaṃ + ca
kaññādānaṃ	kaññā + ādānaṃ
seyyathidanti	so + yathā + idaṃ + iti
tāvadeva	tāva + eva
tāvadevassa	tāva + eva + assa
tāvāhaṃ	tāva + ahaṃ
nanti	naṃ + iti
tāpi	tā + api
taṃpassa	taṃ + api + assa
maṃyeva	maṃ + eva
mañhi	maṃ + hi
maññeva	maṃ + eva
santettha	santi + ettha
santibhūtaṃ	santi + bhūtaṃ
santiupāyameva	santi + upāyaṃ + eva
udakaṭṭhānetipi	udaka + ṭhāne + iti + api
uraṭṭhiṃ	ura + aṭṭhiṃ
nevāhaṃ	na + eva + ahaṃ
yaññupāsanādinā	yaṃ + upāsana + ādinā
hāyasmantotiādimāhaṃsu	hi + āyasmanto + iti + ādiṃ + āhaṃsu
yampidaṃ	yaṃ + api + idaṃ
tiha	t + iha
disañca	disaṃ + ca
nāpi	na + api
nesā	na + esā
neso	na + eso
nesohamasmi	na + eso + ahaṃ + asmi
nete	na + ete
neva	na + eva
nevassa	na + eva + assa
nevattabyābādhāyapi	na + eva + attabyābādhāya + api
nevattantapo	na + eva + attantapo
nevattānukkaṃseti	na + eva + attānukkaṃseti
yāhaṃ	yaṃ + ahaṃ
yāhaṃ	yā + ahaṃ
yaṃkiñci	yaṃ + kiñci
yaṃnūnāhaṃ	yaṃ + nūna + ahaṃ
yaṃnūnāhamettha	yaṃ + nūna + ahaṃ + ettha
yaṃnūnāhanti	yaṃ + nūna + ahaṃ + iti
yampi	yaṃ + api
yampissa	yaṃ + api + assa
yampudāyi	yaṃ + api + udāyi
yaṃyadeva	yaṃ + yad + eva
yañhi	yaṃ + hi
yannūnāhanti	yaṃ + nūna + ahaṃ + iti
yāpi	yā + api
yāpissa	yā + api + assa
yeva	y + eva
yeva	eva
yevāha	eva + āha
yevāti	eva + iti
yeveso	eva + eso
yevettha	eva + ettha
sopāsi	so + api + āsi
svāhaṃ	so + ahaṃ
svāssāti	so + assa + iti
taṃmuhuttajātarattavacchasadisacakkhubhaṇḍoti	taṃ + muhutta + jāta + ratta + vaccha + sadisa + cakkhu + bhaṇḍo + iti
tetiādimāha	te + iti + ādiṃ + āha
yāvade	yāva + eva
tasmātiha	tasmā + iha
tasmātihāti	tasmā + iha + iti
ānetīti	āneti + iti
pireti	api + are + iti
ātūti	ātu + iti
kenacidevāti	kenaci + eva + iti
imināvārahāmevāhaṃ	iminā + eva + arahāmi + eva + ahaṃ
raññikiṭāgirināmo	arañña + kiṭāgiri + nāmo
itiha	iti + ha
itiha	iti + iha
itveva	iti + eva
āsāti	āsā + iti
kvatthoti	ko + attho + iti
āmāhanti	āma + ahaṃ + iti
dhīti	dhī + iti
itvevāti	iti + eva + iti
aduñhi	aduṃ + hi
alañhi	alaṃ + hi
alanti	alaṃ + iti
alamettāvatā	alaṃ + ettāvatā
alamidaṃ	alaṃ + idaṃ
alametanti	alaṃ + etaṃ + iti
kutassa	kuto + assa
asiñca	asiṃ + ca
asimeva	asiṃ + eva
asimāvudhañca	asiṃ + āvudhaṃ + ca
kevalinosmaseti	kevalino + asmase + iti
asmāti	asmā + iti
seyyaṃsoti	seyyaṃ + so + iti
seyyaṃsoti	seyyaṃso + iti
pāpiyaṃsoti	pāpiyaṃ + so + iti
pāpiyaṃsoti	pāpiyaṃso + iti
kathaṃsūti	kathaṃsu + iti
aññadeva	añña + eva
iticiticeva	iti + ca + iti + ca + eva
sammadeva	sammā + eva
kismiñcideva	kismiñci + eva
kismiñcideva	kismiṃ + ci + eva
yaññadeva	yaṃ + yad + eva
yāvadeva	yāva + eva
ahudeva	ahu + eva
kocideva	koci + eva
kiñcideva	kiñci + eva
kiñcideva	kiṃ + ci + eva
yāvadevāti	yāva + eva + iti
sakidevāti	saki + eva + iti
sammadevāti	sammā + eva + iti
bahudevarattiṃ	bahu + eva + rattiṃ
yāvatādohipīti	yāvatā + do + hi + api + iti
yāvatādohipi	yāvatā + do + hi + api
teyevāti	te + eva + iti
āyasmānoti	āyasmā + nu + iti
nāhametamatthaṃ	na + ahaṃ + etaṃ + atthaṃ
sukhīti	sukhī + iti
natveva	na + tu + eva
imināmahaṃ	iminā + ahaṃ
imināpaṅgena	iminā + api + aṅgena
metaṃ	me + etaṃ
mettha	me + ettha
meti	me + iti
mesi	me + asi
myāyaṃ	me + ayaṃ
māhu	ma + ahu
māhu	mā + ahu
nāhamettha	na + ahaṃ + ettha
alameva	alaṃ + eva
metthāti	me + ettha + iti
metiādimāha	me + iti + ādiṃ + āha
nāhamevaṃ	na + ahaṃ + evaṃ
noti	no + iti
yevassa	eva + assa
nevāyaṃ	na + eva + ayaṃ
sova	so + eva
nevarūpī	na + eva + rūpī
tuṇhībhūtova	tuṇhībhūto + eva
itihame	iti + ha + ime
nevidaṃ	na + eva + idaṃ
nevaṃ	na + evaṃ
nevatthi	na + eva + atthi
nevantavā	na + eva + antavā
atthāhaṃ	atthi + ahaṃ
tedha	te + idha
nayidaṃ	na + idaṃ
amāhaṃ	amuṃ + ahaṃ
amāhaṃ	ama + ahaṃ
yamahaṃ	yaṃ + ahaṃ
tayidaṃ	ta + idaṃ
natvevāti	na + tu + eva + iti
yamidaṃ	yaṃ + idaṃ
yamudāyi	yaṃ + udāyi
svepi	so + api
bhāvitamāsiṃsati	bhāvitaṃ + āsiṃsati
pādagaṇṭhirahu	pādagaṇṭhi + ahu
yadūpaghātāya	yad + upaghātāya
yadānulomikaṃ	yad + anulomikaṃ
micchaṃ	m + icchaṃ
tissu	iti + assu
yampicchaṃ	yaṃ + api + icchaṃ
namatthi	na + me + atthi
tāpāhaṃ	tā + api + ahaṃ
atthītissa	atthi + iti + assa
jitamhā	jita + amhā
nevasassato	na + eva + sassato
svāssudaṃ	so + assudaṃ
svāssudaṃ	so + sudaṃ
yañcassāhaṃ	yaṃ + ca + assa + ahaṃ
sopāgā	so + upagā
sopāgā	so + api + āgā
yaṃpāvuso	yaṃ + api + āvuso
vohaṃ	vo + ahaṃ
nevattānaṃ	na + eva + attānaṃ
yaṃnūna	yaṃ + nūna
vodhammā	vo + dhammā
nāmaso	nāma + so
mampi	maṃ + api
jhāyatisu	jhāyati + su
time	ti + ime
sopāga	so + upāga
svajja	so + ajja
yekeci	ye + keci
māssu	mā + ssu
yaṃnūnāhampi	yaṃ + nūna + ahaṃ + api
jalatisu	jalati + su
midhekacce	m + idha + ekacce
midhekacce	idha + ekacce
āmāvuso	āma + āvuso
yasassiso	yasassi + so
yasassiso	yasassī + so
jalatassu	jalati + assu
jhāyatassu	jhāyati + assu
nāvuso	na + āvuso
mahañca	mahaṃ + ca
āmoti	āmo + iti
tyāssa	te + assa
tyassu	te + assu
nevasassataṃ	na + eva + sassataṃ
yeso	yo + eso
piyāmesi	piyā + me + asi
aggohamasmi	aggo + ahaṃ + asmi
dhiratthu	dhi + atthu
nopi	no + api
yañcetaṃ	yaṃ + ca + etaṃ
yañceva	yaṃ + ca + eva
itova	ito + eva
māhevaṃ	mā + hi + evaṃ
aṭṭhāhaṃ	aṭṭha + ahaṃ
nāḷakaraññikiṭāgirināmo	nāḷaka + arañña + kiṭāgiri + nāmo
vihitakaṃno	vihitakaṃ + no
tiādivacanaṃ	iti + ādi + vacanaṃ
appicchassāyaṃ	appicchassa + ayaṃ
santuṭṭhassāyaṃ	santuṭṭhassa + ayaṃ
pavivittassāyaṃ	pavivittassa + ayaṃ
āraddhavīriyassāyaṃ	āraddhavīriyassa + ayaṃ
upaṭṭhitasatissāyaṃ	upaṭṭhitasatissa + ayaṃ
samāhitassāyaṃ	samāhitassa + ayaṃ
nippapañcassāyaṃ	nippapañcassa + ayaṃ
mapi	m + api
nevassu	na + eva + ssu
yidaṃ	y + idaṃ
yidaṃ	idaṃ
yañhissa	yaṃ + hi + assa
nāhamasmi	na + ahaṃ + asmi
asuyeva	asu + eva
nayimaṃ	na + imaṃ
nevattabyābādhāya	na + eva + attabyābādhāya
nāpahosiṃ	na + api + ahosiṃ
mābhinandi	mā + abhinandi
yañcāhaṃ	yaṃ + ca + ahaṃ
nevattānukkaṃsessāma	na + eva + attānukkaṃsessāma
yañcāvuso	yaṃ + ca + āvuso
kosu	ko + su
nevattānukkaṃsissāma	na + eva + attānukkaṃsissāma
evaṃbyākho	evaṃ + byā + kho
yampāvuso	yaṃ + api + āvuso
tebhikkhū	te + bhikkhū
yaṃsa	yaṃ + assa
sopikho	so + api + kho
tyāvuso	te + āvuso
metamāsado	mā + etaṃ + āsado
māhaṃ	mā + ahaṃ
yañcassa	yaṃ + ca + assa
atthānanda	atthi + ānanda
appatissotissa	appatisso + iti + assa
tamenāññataro	taṃ + ena + aññataro
evaṃbyākhoti	evaṃ + byā + kho + iti
maññantīti	maññanti + iti
naṅgulīhi	na + aṅgulīhi
yodhapuññañca	yo + idha + puññaṃ + ca
yodhakāme	yo + idha + kāme
yodhataṇhaṃ	yo + idha + taṇhaṃ
devātipadesu	devā + iti + padesu
adhidevātipadesu	adhidevā + iti + padesu
atthetanti	atthi + etaṃ + iti
māheva	mā + hi + eva
sossa	so + assa
santetthekacce	santi + ettha + ekacce
kiñcanatasmiṃ	kiñcanatā + asmiṃ
kirame	kira + ime
atthitevassa	atthi + iti + eva + assa
khajjabhojjarasalābhiruttamaṃ	khajjabhojjarasalābhi + uttamaṃ
middhī	m + iddhī
yantitthiyo	yanti + itthiyo
yaṃpāyasmā	yaṃ + api + āyasmā
vāssa	vā + assa
yampimaṃ	yaṃ + api + imaṃ
apaṇṇakante	apaṇṇakaṃ + te
manubrūhaye	m + anubrūhaye
ādiyeva	ādi + eva
cevuttāsavā	ca + eva + uttāsavā
nevussādeyya	na + eva + ussādeyya
nevussādanā	na + eva + ussādanā
nevubhato	na + eva + ubhato
yāpetāyasmā	yāpetu + āyasmā
evammettha	evaṃ + me + ettha
tenevovādena	tena + eva + ovādena
nevidha	na + eva + idha
nayime	na + ime
cedaṃ	ce + idaṃ
yaṃnūnassāhaṃ	yaṃ + nūna + assa + ahaṃ
mānubyañjanaggāhī	mā + anubyañjanaggāhī
nevāsaṃ	na + eva + āsaṃ
sammāsaṅkappaṃpahaṃkyādīsupi	sammāsaṅkappaṃ + api + ahaṃ + kiṃ + ādīsu + api
tepīdha	te + api + idha
yidanti	idaṃ + iti
panassāti	pana + assa + iti
pabbatassāti	pabbata + assa + iti
ehayyebhiramāmaseti	ehi + ayye + abhiramāmase + iti
ramāmaseti	ramāmase + iti
puratthamatthi	puratthaṃ + atthi
tyāhutiṃ	te + āhutiṃ
tyāyaṃ	te + ayaṃ
yamariyagarahī	yaṃ + ariyagarahī
yamariye	yaṃ + ariye
yamariyaṃ	yaṃ + ariyaṃ
nahanūnimassa	na + ha + nūna + imassa
tyatthu	te + atthu
tyāssudaṃ	ta + assudaṃ
mejja	me + ajja
kome	ko + ime
mañca	maṃ + ca
nāmamhehi	nāma + amhehi
labhatippasādaṃ	labhati + pasādaṃ
labhatippasaṃsanti	labhati + pasaṃsaṃ + iti
yānukampā	yo + anukampā
sānukampā	so + anukampā
tuṇhībhūtāyamuttarā	tuṇhībhūtā + ayaṃ + uttarā
māyime	mā + ime
voti	vo + iti
gahitosīti	gahito + asi + iti
nāvattena	na + āvattena
yadāsvāhaṃ	yadā + so + ahaṃ
yannūna	yaṃ + nūna
pāpakampissa	pāpakaṃ + api + assa
mañcepi	maṃ + ce + api
tetamanuvatteti	te + taṃ + anuvatteti
yampāyasmā	yaṃ + api + āyasmā
yannūnāhampi	yaṃ + nūna + āhaṃ + api
nevasekkho	na + eva + sekkho
nāsekkho	na + asekkho
yannu	yaṃ + nu
alaṃvacanāyāti	alaṃ + vacanāyā + iti
yannūnassāhaṃ	yaṃ + nūna + assa + ahaṃ
sāhaṃ	sā + ahaṃ
sāhaṃ	so + ahaṃ
nevajjhagā	na + eva + ajjhagā
itonidānā	ito + nidānā
kosudha	ko + su + idha
asatañca	asataṃ + ca
sodha	so + idha
pire	api + re
samphalanti	saṃ + phalaṃ + iti
sohamete	so + ahaṃ + ete
nayidha	na + idha
soti	so + iti
yañce	yaṃ + ce
kedha	ke + idha
svahaṃ	so + ahaṃ
nesa	na + esa
yedha	ye + idha
nocidhāpakataṃ	no + ce + idha + apakataṃ
nocidhāpagataṃ	no + ce + idha + apagataṃ
yannūnāhaṃ	yaṃ + nūna + ahaṃ
tyassa	te + assa
voccayanti	vo + accayaṃ + iti
aṭṭhīyakapiṇḍameti	aṭṭhīyakapiṇḍaṃ + eti
nocīdha	no + ca + idha
santīdha	santi + idha
vatāyanti	vata + ayaṃ + iti
thenosīti	theno + asi + iti
pādārahenavā	pādārahena + vā
atirekapādenavāti	atirekapādena + vā + iti
sasaññāyapare	sa + saññā + apare
māyidaṃ	mā + idaṃ
sūlaṃvā	sūlaṃ + vā
laguḷaṃvā	laguḷaṃ + vā
māyimaṃ	mā + imaṃ
āmayye	āma + ayye
yevānanda	ye + ānanda
pubbevassa	pubba + eva + assa
nāgānogāhanena	nāgānaṃ + ogāhanena
nattheso	na + atthi + eso
ahañcetaṃ	ahaṃ + ca + etaṃ
pupphantīti	pupphanti + iti
ubhatobyañjanāsīti	ubhatobyañjanā + asi + iti
āmāyya	āma + ayya
āmāyye	āma + ayye
nāmhākaṃ	na + amhākaṃ
dehimesaṃ	dehi + imesaṃ
māyyo	mā + ayyo
nāyyo	na + ayyo
assamamāgamissanti	assamaṃ + āgamissaṃ + iti
māyidha	mā + idha
ayyenamhi	ayyena + amhi
nāyasmā	na + āyasmā
kvāyaṃ	ko + ayaṃ
naheva	na + hi + eva
nocassa	no + ca + assa
āharayya	āhara + ayya
nayimesaṃ	na + imesaṃ
tañceti	taṃ + ce + iti
acchādetukāmosīti	acchādetukāmo + asi + iti
meyya	me + ayya
jīnosīti	jīno + asi + iti
āgatosīti	āgato + asi + iti
icchatāvuso	icchati + āvuso
handimaṃ	handa + imaṃ
kinte	kiṃ + te
māvuso	mā + āvuso
tāvade	tāva + eva
alametaṃ	alaṃ + etaṃ
yaṃpāhaṃ	yaṃ + api + ahaṃ
yampāhaṃ	yaṃ + api + ahaṃ
kvattho	ko + attho
māyye	mā + ayye
sabboyaṃ	sabbo + ayaṃ
yaṃatthāya	yaṃ + atthāya
apamārikosīti	apamāriko + asi + iti
madhumehikosīti	madhumehiko + asi + iti
accodātosīti	accodāto + asi + iti
nāccodātosīti	nāccodāto + asi + iti
mohapariyuṭṭhitosīti	mohapariyuṭṭhito + asi + iti
vītamohosīti	vītamoho + asi + iti
ajjhāpannosīti	ajjhāpanno + asi + iti
sotāpannosīti	sotāpanno + asi + iti
brāhmaṇosīti	brāhmaṇo + asi + iti
kulavaḍḍhakosīti	kulavaḍḍhako + asi + iti
saṅgharakkhitosīti	saṅgharakkhito + asi + iti
bhāradvājosīti	bhāradvājo + asi + iti
pupphachaḍḍakosīti	pupphachaḍḍako + asi + iti
gorakkhosīti	gorakkho + asi + iti
nahāpitosīti	nahāpito + asi + iti
lekhakosīti	lekhako + asi + iti
nayimesaññeva	na + imesaṃ + eva
nāyya	na + ayya
sañciccavadhasappāṇaṃ	sañcicca + vadha + sappāṇaṃ
nānānayavicittaṃ	nānā + naya + vicittaṃ
nārahatāyaṃ	na + arahati + ayaṃ
nāyye	na + ayye
tassāyaṃ	tassa + ayaṃ
cādhammenadhīyati	ca + adhammena + adhīyati
kumbhamivābhidāti	kumbhaṃ + iva + abhidā + iti
nipannāsīti	nipannā + asi + iti
cattamano	ca + attamano
chindiyeva	chindi + eva
dirattatirattañce	dirattatirattaṃ + ce
etadevaatthāya	etad + eva + atthāya
nāyyā	nu + ayyā
niccamhāti	nicca + amhā + iti
dhuvamhāti	dhuva + amhā + iti
sassatamhāti	sassata + amhā + iti
vimuttītissa	vimuttī + iti + assa
virāgotissa	virāgo + iti + assa
tissa	ti + assa
tissa	iti + assa
nibbidātissa	nibbidā + iti + assa
yathābhūtañāṇadassanantissa	yathābhūtañāṇadassanaṃ + iti + assa
samādhītissa	samādhi + iti + assa
sukhantissa	sukhaṃ + iti + assa
passaddhītissa	passaddhi + iti + assa
pītītissa	pīti + iti + assa
pāmojjantissa	pāmojjaṃ + iti + assa
saddhātissa	saddhā + iti + assa
dukkhantissa	dukkhaṃ + iti + assa
jātītissa	jāti + iti + assa
bhavotissa	bhavo + iti + assa
upādānantissa	upādānaṃ + iti + assa
taṇhātissa	taṇhā + iti + assa
vedanātissa	vedanā + iti + assa
phassotissa	phasso + iti + assa
saḷāyatanantissa	saḷāyatanaṃ + iti + assa
nāmarūpantissa	nāmarūpaṃ + iti + assa
viññāṇantissa	viññāṇaṃ + iti + assa
saṅkhārātissa	saṅkhārā + iti + assa
avijjātissa	avijjā + iti + assa
hāyasmā	hi + āyasmā
natumhā	na + tumhākaṃ
dissatāyaṃ	dissati + ayaṃ
ārakāvassa	ārakā + eva + assa
pucchāmahaṃ	pucchāmi + ahaṃ
yeti	ye + iti
tāvime	tāva + ime
nocedañca	no + ce + idaṃ + ca
nocedaṃ	no + ce + idaṃ
subhantveva	subhaṃ + ti + eva
subhantveva	subhaṃ + tu + eva
kiñcarahāvuso	kiṃ + carahi + āvuso
kamuddiseyyanti	kaṃ + uddiseyyaṃ + iti
tāvadeti	tāva + eva + iti
kiṃvādāyasmantānaṃ	kiṃ + vādī + āyasmantānaṃ
sīhassevitare	sīhassa + eva + itare
nevācināti	na + eva + ācināti
nāraññe	na + araññe
mamovādena	mama + ovādena
bhabbosi	bhabbo + asi
jahantimaṃ	jahanti + imaṃ
etādisāyaṃ	etādiso + ayaṃ
saraṇattano	saraṇaṃ + attano
abhāvitattātissa	abhāvitattā + iti + assa
bhāvitattātissa	bhāvitattā + iti + assa
pañcupādānakkhandhātissa	pañcupādānakkhandhā + iti + assa
arahātissa	arahā + iti + assa
soattā	so + attā
nocamesiyā	no + ca + me + siyā
cittasseso	cittassa + eso
nīlādīhi	nīla + ādīhi
midhekacco	idha + ekacco
ahamovādena	ahaṃ + ovādena
mete	me + te
tepime	te + api + ime
māyasmantānampi	mā + āyasmantānaṃ + api
vācāvatthurevassa	vācāvatthu + eva + assa
vācāvatthudevassa	vācāvatthu + eva + assa
viharantānavassutā	viharantā + anavassutā
athoppiye	atho + appiye
cittamassūpahaññati	cittaṃ + assa + upahaññati
nibbānamuccati	nibbānaṃ + uccati
nibbānamuccatīti	nibbānaṃ uccati + iti
tasmātihāvuso	tasmā + iha + āvuso
itthetanti	ittha + etaṃ + iti
japāmaseti	japāmase + iti
anupaṭṭhitakāyassatītveva	anupaṭṭhitakāyassati + iti + eve
yāvatatthīti	yāvatā + atthi + iti
sammūḷhettha	sammūḷho + ettha
mariyebhi	m + ariyebhi
natumhākameva	na + tumhākaṃ + eva
nume	nu + ime
pariyādiyantevassa	pariyādiyantI + eva + assa
natthassa	natthi + assa
iticīticeva	iti + ca + iti + ca + eva
yathāpitveva	yathā + api + iti + eva
tathevimasmiṃ	tathā + eva + imasmiṃ
caṇḍotveva	caṇḍo + iti + eva
caṇḍoteva	caṇḍo + iti + eva
suratoteva	surato + iti + eva
tidhammo	ti + dhammo
pāhaṃ	pi + ahaṃ
yaṃbahulañca	yaṃbahulaṃ + ca
natvevāhaṃ	na + iti + eva + ahaṃ
cāvahātuṃ	ca + āvahātuṃ
bhadrarāsiyapāṭalīti	bhadra + rāsiya + pāṭalī + iti
mahāyye	mahā + ayye
dhammābhiññeyyāti	dhammā + abhiññeyyā + iti
atthattāti	atthi + attā + iti
natthattāti	natthi + attā + iti
yassapassa	yassa + api + assa
sakalamidaṃ	sakalaṃ + idaṃ
kācimā	kāci + imā
ayamācāro	ayaṃ + ācāro
sacejja	sace + ajja
maccurājāgamissatīti	maccurāja + āgamissati + iti
maccujarākampisminti	maccujara + akampismiṃ + iti
cepāyasmā	ce + api + āyasmā
sacepāyasmā	sace + api + āyasmā
appamattakāyaṃ	appamattaka + ayaṃ
sototveva	soto + iti + eva
sototi	soto + iti
yādha	yā + idha
yāssa	yā + assa
idāhaṃ	ida + ahaṃ
pabhassaramidaṃ	pabhassaraṃ + idaṃ
tepimaṃ	te + api + imaṃ
aggoti	aggo + iti
kamattha	kaṃ + attha
atthesaṃ	atthi + esaṃ
arāpi	arā + pi
sopassa	so + api + assa
saṭhoso	saṭho + so
nevādiṃ	na + eva + ādiṃ
yāvatānanda	yāvatā + ānanda
evassu	eva + assu
yopassa	yo + api + assa
sammukhāmetaṃ	sammukhā + me + etaṃ
panassāhaṃ	pana + ssu + ahaṃ
pabbatātappaṃ	pabbata + ātappaṃ
mayamassu	mayaṃ + assu
vatāyasmā	vata + āyasmā
iccāyaṃ	iti + ayaṃ
iccāyampi	iti + ayaṃ + api
iccāyante	iti + ayaṃ + te
subhanimittantissa	subhanimittaṃ + iti + assa
asubhanimittantissa	asubhanimittaṃ + iti + assa
tathāhāyaṃ	tathā + hi + ayaṃ
aṭṭhaṅgikamāhuposathaṃ	aṭṭhaṅgikaṃ + āhu + uposathaṃ
tassajja	tassa + ajja
osīdatimeva	osīdati + eva
saṃsīdatimeva	saṃsīdati + eva
sandhiyatimeva	sandhiyati + eva
saṃsandatimeva	saṃsandati + eva
sammodatimeva	sammodati + eva
adinnamicchā	adinnaṃ + icchā
pahānakkhayabbayena	pahāna + khaya + vayena
paṭighanimittantissa	paṭighanimittaṃ + iti + assa
manasikārotissa	manasikāro + iti + assa
cetovimuttītissa	cetovimutti + iti + assa
yonisomanasikārotissa	yonisomanasikāro + iti + assa
soyaṃ	so + ayaṃ
yathariva	yathā + eva
yatharivāhaṃ	yathā + eva + ahaṃ
yatharivāyaṃ	yathā + eva + ayaṃ
kathāhaṃ	kathaṃ + ahaṃ
midhekaccassa	idha + ekaccassa
temaṃ	te + imaṃ
yampāyaṃ	yaṃ + api + ayaṃ
vāyāmañca	vāyāmaṃ + ca
nāpissa	na + api + assa
yamenaṃ	yaṃ + enaṃ
attantāpo	attaṃ + tāpo
asasmīti	asa + asmi + iti
yyāssa	ye + assa
yaṃnissitā	yaṃ + nissitā
saṅkhasaddotveva	saṅkhasaddo + iti + eva
bherisaddotveva	bherisaddo + iti + eva
sukhañcetaṃdhivattatīti	sukhaṃ + ca + etaṃ + adhivattati + iti
taṇhāyogena	taṇhā + yogena
cayime	ca + ime
idamassāhaṃ	idaṃ + assa + ahaṃ
sīhassevitaremigā	sīhassa + eva + itare + migā
nājeḷakā	na + ajeḷakā
passāmissānubhāvanti	passāmi + assa + ānubhāvaṃ + iti
snehānvayamivosadhāti	snehānvayaṃ + iva + osadhā + iti
snehamanvāyamivosadhāti	snehaṃ + anvāya + iva + osadhā + iti
rohitassāpare	rohitassa + apare
atthāsaṃ	atthā + āsaṃ
kamatiṭṭhānaṃ	kamati + ṭhānaṃ
anavajjenamhi	anavajjena + amhi
karontākusalaṃ	karonta + akusalaṃ
nassevanti	na + assa + evaṃ + iti
aparāmasanti	aparāmasaṃ + iti
yenayyo	yena + ayyo
vitthārāsubhaṃ	vitthāra + asubhaṃ
vatassāyaṃ	vata + ssu + ayaṃ
vatassāyaṃ	vata + assaṃ + ayaṃ
kāmātveva	kāmā + iti + eva
āyataneti	āyatane + iti
nayimassa	na + imassa
bhikkhutveva	bhikkhu + iti + eva
aṅgantveva	aṅgaṃ + iti + eva
atthetaṃ	atthi + etaṃ
gavesināti	gavesinā + iti
brāhmaṇātveva	brāhmaṇa + iti + eva
khandhimāva	khandhimā + iva
vācatuppādā	vā + catuppādā
caṇḍālimpi	caṇḍāliṃ + api
sayanamathannapānaṃ	sayanaṃ + atha + annapānaṃ
abhiramatāyasmā	abhiramati + āyasmā
nāssassa	nāssa + assa
nāssassa	na + assa + assa
appaṃsupati	appaṃ + supati
sopapajjati	so + upapajjati
sopapajjatīti	so + upapajjati + iti
tyāssume	te + assu + ime
itohaṃ	ito + ahaṃ
tyassudaṃ	te + assudaṃ
khādaneti	khādane + iti
dīghācārāvāsikañca	dīgha + ācāra + āvāsikaṃ + ca
tyassume	te + assu + ime
assanti	assaṃ + iti
jarasāpi	jarasā + api
pathavītveva	pathavī + iti + eva
āpotveva	āpo + iti + eva
tejotveva	tejo + iti + eva
vāyotveva	vāyo + iti + eva
kāmarāgarattāyaṃ	kāmarāgaratta + ayaṃ
yete	ye + ete
amissīkatamevassa	amissīkataṃ + eva + assa
nayimāni	na + imāni
taṭṭhānā	ta + ṭhānā
sāpissa	sā + api + assa
tyāpare	te + āpare
tyāpare	te + apare
vayañcassānupassatīti	vayaṃ + ca + assa + anupassati + iti
yassaṃdisaṃ	yassaṃ + disaṃ
atohayaṃ	ato + hi + ayaṃ
itopāyaṃ	ito + api + ayaṃ
yañcassā	yaṃ + ca + assā
puññamahitaṃ	puññamahi + taṃ
atthuttari	atthi + uttari
saṃvaṭṭamānassudāhaṃ	saṃvaṭṭamāna + sudaṃ + ahaṃ
sambhatamassa	sambhataṃ + assa
yācīdha	yā + ca + idha
tāti	tā + iti
pabbatāmapi	pabbataṃ + api
itāyaṃ	iti + ayaṃ
khīṇanteva	khīṇaṃ + iti + eva
dukkhamanattā	dukkhaṃ + anattā
manusāsi	m + anusāsi
niddhamathetaṃ	niddhamatha + etaṃ
ahamaṭṭhitomhīti	ahaṃ + aṭṭhito + amhi + iti
ajāyihaṃ	ajāyi + ahaṃ
nevadassanena	na + eva + dassanena
natthiyā	na + atthiyā
nonatthiyā	no + na + atthiyā
naaññamaññe	na + aññaṃ + aññe
naadhipatipaccayā	na + adhipati + paccayā
noupādā	no + upādā
vātiādi	vā + iti + ādi
nevavipākanavipākadhammadhammo	na + eva + vipāka + na + vipāka + dhamma + dhammo
nevācayagāmināpacayagāmī	na + eva + ācayagāmī + na + apacayagāmī
nevācayagāmināpacayagāmiṃ	na + eva + ācayagāmī + na + apacayagāmiṃ
nevācayagāmināpacayagāmissa	na + eva + ācayagāmī + na + apacayagāmissa
nevācayagāmināpacayagāmiñca	na + eva + ācayagāmī + na + apacayagāmiṃ + ca
nevācayagāmināpacayagāmino	na + eva + ācayagāmī + na + apacayagāmino
nevācayagāmināpacayagāminī	na + eva + ācayagāmī + na + apacayagāminī
noavigate	no + avigate
tāvettha	tāva + ettha
svassa	so + assa
nediso	na + ediso
tyajja	te + ajja
tedāni	te + dāni
yampānanda	yaṃ + api + ānanda
suddhāsuddhehi	suddhā + suddhehi
kāmaññe	kāmā + aññe
malitthiyā	malaṃ + itthiyā
aṭṭhahākārehi	aṭṭhahi + ākārehi
pātimokkhanti	pātimokkhaṃ + iti
upaṭṭhitassatissāyaṃ	upaṭṭhitassatissa + ayaṃ
nippapañcārāmassāyaṃ	nippapañcārāmassa + ayaṃ
catūhāvuso	catūhi + āvuso
sāvassā	sā + eva + assā
anatikkamanīyāti	anatikkamanīyā + iti
āyañca	āyaṃ + ca
tīhāvuso	tīhi + āvuso
dvīhāvuso	dvīhi + āvuso
nūname	nūna + ime
hanūname	ha + nūna + ime
paname	pana + ime
navahaṅgehi	navahi + aṅgehi
vuḍḍhihesā	vuḍḍhi + hi + esā
tāvāyaṃ	tāva + ayaṃ
panassāvuso	pana + assa + āvuso
cassānupassati	ca + assa + anupassati
cassānupassatīti	ca + assa + anupassati + iti
tiādinā	iti + ādinā
jhāyīhete	jhāyī + hi + ete
tathāhimaṃ	tathā + hi + imaṃ
atthābhinibbattesuṃ	attha + abhinibbattesuṃ
parisuddhenamhi	parisuddhena + amhi
nīvaraṇātissa	nīvaraṇā + iti + assa
asatāsampajaññantissa	asatāsampajaññaṃ + iti + assa
ayonisomanasikārotissa	ayonisomanasikāro + iti + assa
assaddhiyantissa	assaddhiyaṃ + iti + assa
asaddhammassavanantissa	asaddhammassavanaṃ + iti + assa
asappurisasaṃsevotissa	asappurisasaṃsevo + iti + assa
bojjhaṅgātissa	bojjhaṅgā + iti + assa
sattapāhaṃ	satta + api + ahaṃ
satipaṭṭhānātissa	satipaṭṭhānā + iti + assa
cattāropāhaṃ	cattāro + api + ahaṃ
indriyasaṃvarotissa	indriyasaṃvaro + iti + assa
satisampajaññantissa	satisampajaññaṃ + iti + assa
saddhammassavanantissa	saddhammassavanaṃ + iti + assa
sappurisasaṃsevotissa	sappurisasaṃsevo + iti + assa
assaddhammassavanantissa	assaddhammassavanaṃ + iti + assa
pāṭikaṅkhanti	pāṭikaṅkhaṃ + iti
pāsaṃsametaṃ	pāsaṃsaṃ + etaṃ
hirīmāyaṃ	hirīmā + ayaṃ
tintiṇapadaniddese	tintiṇa + pada + niddese
tathāhissa	tathā + hi + assa
kiṃdiṭṭhikosi	kiṃdiṭṭhiko + asi
tuvanti	tuvaṃ + iti
pacchāpetaṃ	pacchā + api + etaṃ
nameso	na + me + eso
tettha	te + ettha
hupāli	hi + upāli
nanvāyaṃ	nanu + ayaṃ
idamatthaṃtissa	idaṃ + atthaṃ + iti + assa
indriyaasaṃvarotissa	indriyaasaṃvaro + iti + assa
upāraddhasmāti	upāraddha + asmā + iti
upāraddhamhāti	upāraddha + amhā + iti
aṭṭhāneti	aṭṭhāne + iti
miccādinā	miccā + ādinā
idamatthantissa	idaṃ + atthaṃ + iti + assa
pajahateva	pajahati + eva
dhammantipadassa	dhammaṃ + iti + padassa
appakampi	appakaṃ + api
maṅgalamuttamanti	maṅgalaṃ + uttamaṃ + iti
yathindakhīlo	yathā + indakhīlo
catūhapāyehi	catūhi + apāyehi
cābhiṭhānāni	ca + abhiṭhānāni
virattacittāyatike	virattacittā + āyatike
gorakkhettha	gorakkha + ettha
caññā	ca + aññā
petānamatthāya	petānaṃ + atthāya
hitāyassa	hitāya + assa
karaṇīyamatthakusalena	karaṇīyaṃ + atthakusalena
yantasantaṃ	yaṃ + taṃ + santaṃ
nāññamaññassa	na + aññamaññassa
nāññamaññassa	na + aññaṃ + aññassa
yāvatāssa	yāvatā + assa
vihāramidhamāhu	vihāraṃ + idha + āhu
retīti	r + eti + iti
maparājitā	m + aparājitā
tāvassunihito	tāva + ssu + nihito
cakkaṃva	cakkaṃ + iva
rukkhaṃva	rukkhaṃ + iva
rukkhaṃva	rukkhaṃ + eva
uṭṭhānenappamādena	uṭṭhānena + appamādena
pabbataṭṭhova	pabbataṭṭho + iva
okamokataubbhato	okaṃ + okato + ubbhato
kāyamimaṃ	kāyaṃ + imaṃ
niratthaṃva	niratthaṃ + iva
komaṃ	ko + imaṃ
pupphamiva	pupphaṃ + iva
pupphamivappacessati	pupphaṃ + iva + pacessati
mahoghova	mahogho + iva
attanova	attano + eva
dhanammatthi	dhanaṃ + me + atthi
khīraṃva	khīraṃ + iva
bhasmacchannova	bhasmacchanno + iva
muddhamassa	muddhaṃ + assa
bhāvanamiccheyya	bhāvanaṃ + iccheyya
mamevātivasā	maṃ + eva + ativasā
nidhīnaṃva	nidhīnaṃ + iva
ovadeyyānusāseyya	ovadeyya + anusāseyya
noccāvacaṃ	na + uccāvacaṃ
puttamicche	puttaṃ + icche
nayicche	na + icche
haṃsāva	haṃsa + iva
yassāsavā	yassa + āsavā
rahadova	rahado + iva
gāthātipadassa	gāthā + iti + padassa
jeyyamattānaṃ	jeyyaṃ + attānaṃ
duvidhajjhānanibbattanasamatthaṃ	duvidha + jhāna + nibbattana + samatthaṃ
kayirāthetaṃ	kayirātha + etaṃ
māvamaññetha	mā + avamaññetha
māppamaññetha	mā + appamaññetha
jīvitukāmova	jīvitukāmo + iva
nābbaṇaṃ	na + abbaṇaṃ
visamanveti	visaṃ + anveti
māvoca	mā + avoca
kasāmiva	kasā + iva
parijiṇṇamidaṃ	parijiṇṇaṃ + idaṃ
yānimānipaviddhāni	yāna + imāni + apaviddhāni
yānimānipaviddhāni	yāni + imāni + apaviddhāni
alābūneva	alābūni + eva
alāpūneva	alāpūni + eva
balibaddhova	balibaddho + iva
balivaddova	balivaddo + iva
jiṇṇakoñcāva	jiṇṇakoñcā + iva
khīṇamaccheva	khīṇamacche + iva
cāpātikhīṇāva	cāpātikhīṇā + iva
yathāññamanusāsati	yathā + aññamanusāsati
vasmamayaṃ	v + asmamayaṃ
vajiraṃvamhamayaṃ	vajiraṃ + iva + amhamayaṃ
sālamivotthataṃ	sālaṃ + iva + otthataṃ
nāññamañño	na + aññamañño
nāññamañño	nāññaṃ + añño
attadatthamabhiññāya	attadatthaṃ + abhiññāya
jitamassa	jitaṃ + assa
ñātīnaṃva	ñātīnaṃ + iva
nakkhattapathaṃva	nakkhattapathaṃ + iva
yuñjamattānaṃ	yuñjaṃ + attānaṃ
sotthimāgataṃ	sotthiṃ + āgataṃ
katapuññampi	katapuññaṃ + api
bhantaṃva	bhantaṃ + iva
dajjāppasmimpi	dajjā + appasmim + api
ajjatanāmiva	ajjatanāṃ + iva
ajjatanāmiva	ajjatanaṃ + iva
mitabhāṇimpi	mitabhāṇiṃ + api
paṇḍupalāsova	paṇḍupalāso + iva
yamapurisāpi	yamapurisā + api
pātheyyampi	pātheyyaṃ + api
idhevameso	idha + eva + eso
kaliṃva	kaliṃ + iva
buddhānamiñjitaṃ	buddhānaṃ + iñjitaṃ
tulaṃva	tulaṃ + iva
varamādāya	varaṃ + ādāya
maggānaṭṭhaṅgiko	maggānaṃ + aṭṭhaṅgiko
maggamisippaveditaṃ	maggaṃ + isippaveditaṃ
khīrapakova	khīrapako + iva
sāradikaṃva	sāradikaṃ + iva
santimaggameva	santimaggaṃ + eva
himavantova	himavanto + iva
asantettha	asanto + ettha
damayamattānaṃ	damayaṃ + attānaṃ
raṭṭhapiṇḍamasaññato	raṭṭhapiṇḍaṃ + asaññato
nirayāyupakaḍḍhati	nirayāya + upakaḍḍhati
rājābhirūhati	rājā + abhirūhati
ājānīyāva	ājānīyā + eva
kuñjarāva	kuñjarā + eva
mahāvarāhova	mahāvarāho + iva
uddharathattānaṃ	uddharatha + attānaṃ
sannova	sanno + iva
sattova	satto + iva
phalamicchaṃva	phalaṃ + icchaṃ + iva
abhivaṭṭhaṃva	abhivaṭṭhaṃ + iva
abhivaḍḍhaṃva	abhivaḍḍhaṃ + iva
abhivaṭṭaṃva	abhivaṭṭaṃ + iva
yāvantettha	yāvanto + ettha
naḷaṃva	naḷaṃ + iva
sasova	saso + iva
rāgarattānupatanti	rāgarattā + anupatanti
makkaṭakova	makkaṭako + iva
dukkhamidanti	dukkha + idaṃ + iti
tatrāyamādi	tatra + ayaṃ + ādi
codayattānaṃ	codaya + attānaṃ
saṃyamamattānaṃ	saṃyamaṃ + attānaṃ
saṃyamayattānaṃ	saṃyamaya + attānaṃ
bhadraṃva	bhadraṃ + iva
virajamāsīnaṃ	virajaṃ + āsīnaṃ
katakiccamanāsavaṃ	katakiccaṃ + anāsavaṃ
brāhmaṇassetadakiñci	brāhmaṇassa + etad + akiñci
aggihuttaṃva	aggihuttaṃ + iva
pokkharapatteva	pokkharapatte + iva
saccamudīraye	saccaṃ + udīraye
saṅgamupaccagā	saṅgaṃ + upaccagā
satevīsacatussatā	sa + tevīsa + catusatā
attalokaṃ	atta + lokaṃ
dhammaṭṭhamaggañca	dhammaṭṭha + maggaṃ + ca
gāthāyuddānaṃ	gāthāya + uddānaṃ
jarattekādasa	jarā + atta + ekādasa
pupphabālasahassamhi	puppha + bāla + sahassamhi
pāpasukhamhi	pāpa + sukhamhi
satevīsa	sa + tevīsa
yamakappamādo	yamaka + appamādo
gāthānamuddānaṃ	gāthānaṃ + uddānaṃ
jīvakapañhavatthu	jīvaka + pañha + vatthu
belaṭṭhasīsattheravatthu	belaṭṭhasīsa + thera + vatthu
anuruddhattheravatthu	anuruddha + thera + vatthu
mahākaccāyanattheravatthu	mahākaccāyana + thera + vatthu
anatthapucchakabrāhmaṇavatthu	anattha + pucchaka + brāhmaṇa + vatthu
sahāyakabrāhmaṇavatthu	sahāyaka + brāhmaṇa + vatthu
abalassaṃva	abalassaṃ + iva
ñātīva	ñātī + iva
ayasāva	ayasā + iva
sūriyova	sūriyo + iva
suriyova	suriyo + iva
yassussadā	yassa + ussadā
disvānassā	disvāna + assā
ummujjanimujjampi	ummujjanimujjaṃ + api
thūpañcassa	thūpaṃ + ca + assa
attanāvedi	attanā + avedi
khuddaputtāmhi	khuddaputtā + amhi
yañcidaṃ	yaṃ + ca + idaṃ
phassāti	phassā + iti
paramanti	paramaṃ + iti
yassantarato	yassa + antarato
bhavissantipissa	bhavissaṃ + iti + api + assa
vanavasesā	vā + anavasesā
taṇhakkhayasukhassete	taṇhakkhayasukhassa + ete
muñcāmahaṃ	muñcāmi + ahaṃ
tete	te + ete
pabbatova	pabbato + iva
nibbānamattanoti	nibbānaṃ + attano + iti
yassāyaṃ	yassa + ayaṃ
vippamokkhamāhaṃsu	vippamokkhaṃ + āhaṃsu
nissaraṇamāhaṃsu	nissaraṇaṃ + āhaṃsu
asesamete	asesaṃ + ete
yakkhampi	yakkhaṃ + api
yassevaṃ	yassa + evaṃ
jīvitampi	jīvitaṃ + api
nayimehi	na + imehi
upeccapi	upecca + api
uppatitvāpi	uppatitvā + api
palāyatanti	palāyataṃ + iti
kilantosīti	kilanto + asi + iti
kilantomhīti	kilanto + amhā + iti
kilantomhīti	kilanto + amhi + iti
kalyāṇiyāsi	kalyāṇiyā + asi
cāsi	ca + asi
visamānīva	visamāni + iva
siddhamidanti	siddhaṃ + idaṃ + iti
vidūti	vidū + iti
tamogadhanti	taṃ + ogadhaṃ + iti
saṅgamaticca	saṅgaṃ + aticca
metīti	m + eti + iti
etete	ete + te
pajjotamivādhipātakā	pajjotaṃ + iva + adhipātakā
obhāsitameva	obhāsitaṃ + eva
anārammaṇamevetaṃ	anārammaṇaṃ + eva + etaṃ
iccheyyāhaṃ	iccheyyaṃ + ahaṃ
navapi	nava + api
paṭiccappabhavanti	paṭicca + pabhavanti
āyujaṭilavekkhaṇā	āyu + jaṭila + paccavekkhaṇā
macchāva	macchā + iva
vaggamidaṃ	vaggaṃ + idaṃ
vaggamidaṭṭhakaṃ	vaggaṃ + ida + aṭṭhakaṃ
udānamitīdamāhu	udānaṃ + iti + idaṃ + āhu
atthāyetaṃ	atthāya + etaṃ
udānamitimāhu	udānaṃ + iti + āhu
udānantidamāhu	udānaṃ + iti + idaṃ + āhu
atthamāgamāti	atthamāgamā + iti
vaggamāhu	vaggaṃ + āhu
tadaṅgādippahānavasena	tad + aṅga + ādi + pahāna + vasena
makkhāgato	makkha + āgato
puññameva	puññaṃ + eva
amaccharāti	amaccharā + iti
manasānukampaṃ	manasā + anukampaṃ
yajamānānupariyagā	yajamānā + anupariyagā
sattimānidha	satta + imāni + idha
suguttānidha	suguttāni + idha
yañcaññaṃ	yaṃ + ca + aññaṃ
katvānākusalaṃ	katvāna + akusalaṃ
akatvākusalaṃ	akatvā + akusalaṃ
akatvākusalaṃ	akatvā + kusalaṃ
suṇāthetaṃ	suṇātha + etaṃ
esanāti	esanā + iti
akathaṃkathīti	akathaṃkathī + iti
savāhananti	savāhanaṃ + iti
muttamanti	m + uttamaṃ + iti
addhāti	addhā + iti
ekasaṃyojanampi	ekasaṃyojanaṃ + api
bhāvitattaññataraṃ	bhāvitatta + aññataraṃ
puttamicchanti	puttaṃ + icchanti
kusāpi	kusā + api
pattāpi	pattā + api
sāsaneti	sāsane + iti
santimevādhigacchatīti	santiṃ + eva + adhigacchati + iti
vuṭṭhīva	vuṭṭhi + iva
tālapakkaṃva	tālapakkaṃ + iva
ādiccovudayaṃ	ādicco + iva + udayaṃ
bhindantāyaṃ	bhindanto + ayaṃ
udabindūva	udabindu + iva
yepassa	ye + api + assa
dassanampahaṃ	dassanaṃ + api + ahaṃ
savanampahaṃ	savanaṃ + api + ahaṃ
upasaṅkamanampahaṃ	upasaṅkamanaṃ + api + ahaṃ
payirupāsanampahaṃ	payirupāsanaṃ + api + ahaṃ
anussaraṇampahaṃ	anussaraṇaṃ + api + ahaṃ
anupabbajjampahaṃ	anupabbajjaṃ + api + ahaṃ
anussatimpahaṃ	anussatiṃ + api + ahaṃ
raṇañjahātipi	raṇañjaha + iti + api
catukkañca	catukkaṃ + ca
ekakamhi	ekako + amhi
yadeko	yadā + eko
sappavisaṃva	sappavisaṃ + iva
jiṇṇamivattacaṃ	jiṇṇaṃ + iva + tacaṃ
jiṇṇamiva	jiṇṇaṃ + iva
bhisapupphaṃva	bhisapupphaṃ + iva
naḷasetuṃva	naḷasetuṃ + iva
vitathamidanti	vitathaṃ + idaṃ + iti
yassānusayā	yassa + anusayā
vuṭṭhimpi	vuṭṭhiṃ + api
saheyyumāgataṃ	saheyyuṃ + āgataṃ
baddhāsi	baddhā + asi
aṭṭhamahāsaṃvegavatthusamāvajjanañca	aṭṭha + mahā + saṃvega + vatthu + samāvajjanaṃ + ca
tāhaṃ	te + ahaṃ
tāhaṃ	taṃ + ahaṃ
imāvuso	ime + āvuso
sahottappañāṇaṃ	saha + ottappa + ñāṇaṃ
abhisāpāyaṃ	abhisāpo + ayaṃ
abhisapāyaṃ	abhisapo + ayaṃ
chavālātaṃva	chavālātaṃ + iva
tvevidaṃ	tu + eva + idaṃ
mahiyekarattivāso	mahiyā + ekarattivāso
punupeyya	aññataraṃ + api
puttamiccheyya	puttaṃ + iccheyya
sandiṭṭhikasamparāyikasokaparidevādinānappakārakaṃ	sandiṭṭhika + samparāyika + sokaparidevā + ādi + nānappakārakaṃ
visālova	visālo + iva
pabbajitāpi	pabbajitā + api
tiṃsapalaguḷapiṇḍappamāṇāva	tiṃsa + pala + guḷapiṇḍa + pamāṇā + eva
sabbānipetāni	sabbāni + api + etāni
parittamettha	parittaṃ + ettha
dukkhamettha	dukkhaṃ + ettha
patthayamappamatto	patthayaṃ + appamatto
padumaṃva	padumaṃ + iva
cundāti	cunda + iti
tādisāti	tādisā + iti
iṇamatthīti	iṇaṃ + atthi + iti
kiñcikkhamādeti	kiñcikkhaṃ + ādeti
jaññāti	jaññā + iti
cattānaṃ	ca + attānaṃ
mavajānāti	m + avajānāti
yathāpedaṃ	yathā + api + idaṃ
pañcamatthi	pañcamo + atthi
sūdha	su + idha
padamaccutaṃ	padaṃ + accutaṃ
aniketamasanthavaṃ	aniketaṃ + asanthavaṃ
jāyantamassa	jāyantaṃ + assa
sinehamassa	sinehaṃ + assa
munimappamattaṃ	muniṃ + appamattaṃ
sīhaṃva	sīhaṃ + iva
vātaṃva	vātaṃ + iva
padmaṃva	padmaṃ + iva
tasaraṃva	tasaraṃ + iva
tāvamhi	tāva + amhi
pañcakkhandhadvādasāyatanadvattiṃsākārasaccapaṭiccasamuppādādivasena	pañcakkhandha + dvādasa + āyatana + dvattiṃsākāra + sacca + paṭiccasamuppāda + ādi + vasena
sālīnamannaṃ	sālīnaṃ + annaṃ
esāmagandho	esa + āmagandho
paresamādāya	paresaṃ + ādāya
macchamaṃsānamanāsakattaṃ	macchamaṃsānaṃ + anāsakattaṃ
satamasnamānā	sataṃ + asnamānā
nāggihuttassupasevanā	na + aggihuttassupasevanā
randhamevānupassī	randhaṃ + eva + anupassī
akkhātampi	akkhātaṃ + api
puññappabhāvānuggahitasarīrā	puñña + pabhāva + anuggahita + sarīrā
brāhmaṇānamadā	brāhmaṇānaṃ + adā
aṭṭhānavutimāgamuṃ	aṭṭhānavutiṃ + āgamuṃ
evameso	evaṃ + eso
bhariyāvamaññatha	bhariyā + avamaññatha
indaṃva	indaṃ + iva
brāhmaṇānāsuṃ	brāhmaṇānaṃ + āsuṃ
tebhirattā	te + abhirattā
veko	vā + eko
heta	hi + eta
isimavocuṃ	isiṃ + avocuṃ
kvajja	kva + ajja
aññāsamatimaññihanti	aññāsaṃ + atimaññi + ahaṃ + iti
paṇṇacchadanasālāpi	paṇṇa + chadana + sālā + api
sappasseva	sappassa + iva
matante	mataṃ + te
cīvaracetāpananti	cīvaracetāpanaṃ + iti
cātumāsapaccayapavāraṇā	cātumāsa + paccayapavāraṇā
uttariñcassa	uttariṃ + ca + assa
buddhādiāmisapūjā	buddha + ādi + āmisa + pūjā
suciraparinibbutopi	suciraparinibbuto + api
pacchimājanatānukampamānasā	pacchimājanatā + anukampamānasā
duggatapaṇṇākārabhūte	duggata + paṇṇākāra + bhūte
ratanattayapaṇāmagāthāyo	ratanattaya + paṇāma + gāthāyo
saṃvegaparikittanapāṭhañca	saṃvega + parikittana + pāṭhaṃ + ca
yoccantasuddhabbarañāṇalocano	yo + accanta + suddha + bara + ñāṇa + locano
pāpūpakilesaghātako	pāpa + upakilesa + ghātako
sabbupaddavā	sabba + upaddavā
janatānukampa	janatā + anukampa
yoccanta	yo + accanta
suddhabbara	suddha + bara
pākāmata	pāka + amata
sukhettābhyati	sukhetta + abhyati
maggapākāmatabhedabhinnako	magga + pāka + amata + bheda + bhinnako
dhammapahaṃsāna	dhamma + pahaṃsāna
dhammapahaṃsānapāṭhaṃ	dhamma + pahaṃsāna + pāṭhaṃ
dvattiṃsākārapaccavekkhaṇa	dvattiṃsa + ākāra + paccavekkhaṇa
dvattiṃsākārapāṭhaṃ	dvattiṃsa + ākāra + pāṭhaṃ
sabbītiyo	sabba + ītiyo
kāladānasuttagāthā	kāladānasutta + gāthā
santikaro	santi + karo
saddhammasenā	saddhamma + senā
pāpūpakilesajetā	pāpa + upakilesa + jetā
santiniyojako	santi + niyojako
namokārānubhāvena	namo + kāra + ānubhāvena
paṭirūpadesavāso	paṭirūpa + desa + vāso
yambuddhaseṭṭho	yaṃ + buddhaseṭṭho
viriyampītipassaddhi	viriyaṃ + pīti + passaddhi
yandunnimittaṃ	yaṃ + dunnimittaṃ
devatāgatā	devatā + gatā
mārātirekamabhiyujjhitasabbarattiṃ	māra + atirekaṃ + abhiyujjhita + sabba + rattiṃ
ghorampanāḷavakamakkhamathaddhayakkhaṃ	ghoraṃ + pana + āḷavakaṃ + akkhama + thaddha + yakkhaṃ
dāvaggicakkamasanīva	dāvaggi + cakkaṃ + asanī + iva
ukkhittakhaggamatihatthasudāruṇantaṃ	ukkhitta + khaggaṃ + atihattha + sudāruṇaṃ + taṃ
dhāvantiyojanapathaṅgulimālavantaṃ	dhāvaṃ + tiyojana + patha + aṅguli + mālavantaṃ
vādābhiropitamanaṃ	vāda + abhiropita + manaṃ
atiandhabhūtaṃ	atiandha + bhūtaṃ
nandopanandabhujagaṃ	nandopananda + bhujagaṃ
iddhūpadesavidhinā	iddhi + upadesa + vidhinā
dinadine	dina + dine
nandivaḍḍhano	nandi + vaḍḍhano
asaṅkiliṭṭhāsaṅkilesikā	asaṅkiliṭṭha + asaṅkilesikā
nevācayagāmino	neva + ācaya + gāmino
nāpacayagāmino	na + apacaya + gāmino
adāsime	adāsi + me
vaññā	vā + aññā
uddissanādhiṭṭhānagāthāyo	uddissana + adhiṭṭhāna + gāthāyo
uddissanādhiṭṭhānā	uddissana + adhiṭṭhānā
vomataṃ	vo + amataṃ
nokāsaṃ	na + okāsaṃ
tesottamānubhāvena	tesaṃ + uttama + ānubhāvena
sattānantāppamāṇakā	satta + ananta + appamāṇakā
cāpyadiṭṭhā	ca + api + adiṭṭhā
catuyonikā	catu + yonikā
pattidānamme	patti + dānaṃ + me
tisaraṇagamanaṃ	ti + saraṇa + gamanaṃ
tisaraṇa	ti + saraṇa
saddhāpakatamesānaṃ	saddhāpakataṃ + esānaṃ
usūyakañca	usūyakaṃ + ca
daḷhamāruhitvā	daḷhaṃ + āruhitvā
nevācare	na + eva + ācare
kāyagatātyatthu	kāyagatā + te + atthu
tamovassa	tamo + eva + assa
paramasuddhippattapañño	parama + suddhi + patta + pañño
pahānamāsavānaṃ	pahānaṃ + āsavānaṃ
anagārameti	anagāraṃ + eti
ñāṇamavecca	ñāṇaṃ + avecca
sotukāmamhāti	sotukāma + amhā + iti
rājadūtābhidhāvantu	rājadūtā + abhidhāvantu
pahitattampi	pahitattaṃ + api
jīvamanupucchasi	jīvaṃ + anupucchasi
mevaṃ	me + evaṃ
pagāḷhettha	pagāḷha + ettha
medavaṇṇaṃva	medavaṇṇaṃ + iva
nomhi	no + amhi
tassijjheti	tassa + ijjhe + iti
hutamijjhe	hutaṃ + ijjhe
vedagumaddasāma	vedaguṃ + addasāma
caññāsi	ca + aññāsi
hutamatthu	hutaṃ + atthu
yaññamāgataṃ	yaññaṃ + āgataṃ
vattayamappamatto	vattayaṃ + appamatto
byagghusabhova	byagghusabho + iva
vīsāyapi	vīsāya + api
tiṃsāyapi	tiṃsāya + api
cattālīsāyapi	cattālīsāya + api
paññāsāyapi	paññāsāya + api
etthappatiṭṭhāya	ettha + patiṭṭhāya
bhāvayamappamāṇaṃ	bhāvayaṃ + appamāṇaṃ
satatamappamatto	satataṃ + appamatto
kenattanā	kena + attanā
careyyāsīti	careyyāsi + iti
daharopi	daharo + api
pattinamāhu	pattinaṃ + āhu
dantamāhu	dantaṃ + āhu
vigatarajamanaṅgaṇaṃ	vigatarajaṃ + anaṅgaṇaṃ
saṃsāramaticca	saṃsāraṃ + aticca
mānusakañca	mānusakaṃ + ca
navamahaggatakusalacetanābhedañca	nava + mahaggata + kusalacetanā + bhedaṃ + ca
jālamaticca	jālaṃ + aticca
vīriyavāti	vīriyavā + iti
yānidhatthi	yāni + idha + atthi
vedamaticca	vedaṃ + aticca
caraṇavāti	caraṇavā + iti
mānamathopi	mānaṃ + atho + api
paribbājakamāhu	paribbājakaṃ + āhu
attanāttānaṃ	attano + attānaṃ
puññakhettamanuttaraṃ	puññakhettaṃ + anuttaraṃ
tesamantakaromi	tesaṃ + antakaromi
okāsakammamattampi	okāsakammamattaṃ + api
okāsamattampi	okāsamattaṃ + api
kaṅkhitamaññāsi	kaṅkhitaṃ + aññāsi
adhivāsetveva	adhivāsetu + eva
animittamanaññātaṃ	animittaṃ + anaññātaṃ
jarampi	jaraṃ + api
phalānamiva	phalānaṃ + iva
evamabbhāhato	evaṃ + abbhāhato
hiṃsamattānaṃ	hiṃsaṃ + attānaṃ
hiṃsamattānamattanā	hiṃsaṃ + attānaṃ + attanā
sokamappajahaṃ	sokaṃ + appajahaṃ
phandantevidha	phandanti + eva + idha
saraṇamādittaṃ	saraṇaṃ + ādittaṃ
tūlaṃva	tūlaṃ + iva
pajappañca	pajappaṃ + ca
puṭṭhumāgamhā	puṭṭhuṃ + āgamhā
nāṅgulīhi	na + aṅgulīhi
dīgharattamanusayitaṃ	dīgharattaṃ + anusayitaṃ
tenevābādhena	tena + eva + ābādhena
bhojanamatthi	bhojanaṃ + atthi
timisamāyanti	timisaṃ + āyanti
nibbānapadābhipatthayāno	nibbānapada + abhipatthayāno
bhiyyassuppajjate	bhiyyo + assa + uppajjate
padakasma	padakā + asma
rajamākirasī	rajaṃ + ākirasī
samuppilavāte	samuppilavā + te
tīramapatthi	tīraṃ + api + atthi
cakkamisivhaye	cakkaṃ + isi + avhaye
nadaṃva	nadaṃ + iva
turitamavasarī	turitaṃ + avasarī
jalitamiva	jalitaṃ + iva
ukkāmukheva	ukkāmukhe + iva
sikhimiva	sikhiṃ + iva
saradarivabbhamuttaṃ	sarada + iva + abbhamuttaṃ
vipulamalattha	vipulaṃ + alattha
athattano	atha + attano
gamanamanussaranto	gamanaṃ + anussaranto
ahitamanussarāmi	ahitaṃ + anussarāmi
cāpimassa	ca + api + imassa
phusissatāyaṃ	phusissati + ayaṃ
vattessatāyaṃ	vattessati + ayaṃ
giramabbhudīrayi	giraṃ + abbhudīrayi
ciramidhāvaseso	ciraṃ + idha + avaseso
dhammamaggaṃ	dhammaṃ + aggaṃ
aññātametaṃ	aññātaṃ + etaṃ
vanantamabhihāraye	vanantaṃ + abhihāraye
attānamabhitosayaṃ	attānaṃ + abhitosayaṃ
gāmantamabhihāraye	gāmantaṃ + abhihāraye
gāmamāgamma	gāmaṃ + āgamma
rukkhaṃvupanivattati	rukkhaṃ + eva + upanivattati
monamakkhātaṃ	monaṃ + akkhātaṃ
pūrova	pūro + iva
dvayatānupassanāti	dvayatānupassanā + iti
siyātissu	siyā + iti + assu
upadhipaccayāti	upadhipaccayā + iti
avijjāyeva	avijjāya + eva
phassapaccayāti	phassapaccayā + iti
taṇhāpaccayāti	taṇhāpaccayā + iti
upādānapaccayāti	upādānapaccayā + iti
ārambhapaccayāti	ārambhapaccayā + iti
āhārapaccayāti	āhārapaccayā + iti
iñjitapaccayāti	iñjitapaccayā + iti
santatarāti	santatarā + iti
diṭṭhamariyehi	diṭṭhaṃ + ariyehi
sampamūḷhetthaviddasu	sampamūḷha + ettha + aviddasu
upādānārambhaāhārā	upādāna + ārambha + āhārā
soḷasāti	soḷasā + iti
monamajjhagāti	monamajjhagā + iti
sallaviddhova	sallaviddho + iva
maddantenaṃ	maddanti + enaṃ
bhinnamivodakaṃ	bhinnaṃ + iva + odakaṃ
bahunābhichanno	bahunā + abhichanno
purimeva	purime + eva
visamanti	visamaṃ + iti
appañhidaṃ	appaṃ + hi + idaṃ
maccheva	macche + iva
āsattimakubbamāno	āsattiṃ + akubbamāno
caramappamatto	caraṃ + appamatto
duṭṭhamanāpi	duṭṭhamanā + api
kathamaccayeyya	kathaṃ + accayeyya
anānupuṭṭhova	anānupuṭṭho + eva
tamariyadhammaṃ	taṃ + ariyadhammaṃ
yadattani	yad + attani
māyañca	māyaṃ + ca
diṭṭhimidheva	diṭṭhiṃ + idha + eva
evābhijānaṃ	evaṃ + abhijānaṃ
etābhijānaṃ	etaṃ + abhijānaṃ
suddhimāha	suddhiṃ + āha
hīnāti	hīnā + iti
sabbamāha	sabbaṃ + āha
yadattanī	yad + attanī
hīnamaññaṃ	hīnaṃ + aññaṃ
diṭṭhimpi	diṭṭhiṃ + api
samoti	samo + iti
attānamanūpaneyya	attānaṃ + anūpaneyya
ñāṇepi	ñāṇe + api
diṭṭhimapi	diṭṭhiṃ + api
yassūbhayante	yassa + ubhayante
paṇidhīdha	paṇidhi + idha
aṇūpi	aṇu + api
diṭṭhimanādiyānaṃ	diṭṭhiṃ + anādiyānaṃ
vassasatāpi	vassasatā + api
vinābhāvasantamevidaṃ	vinābhāva + santaṃ + eva + idaṃ
mamidanti	mama + idaṃ + iti
mamayidanti	mama + idaṃ + iti
diṭṭhāpi	diṭṭhā + api
sutāpi	sutā + api
nāmamidaṃ	nāmaṃ + idaṃ
nāmamevāvasissati	nāmaṃ + eva + avasissati
vivittamāsanaṃ	vivittaṃ + āsanaṃ
sāmaggiyamāhu	sāmaggiyaṃ + āhu
visuddhimicchati	visuddhiṃ + icchati
methunamanuyuttassa	methunaṃ + anuyuttassa
metteyyāti	metteyya + iti
hīnamāhu	hīnaṃ + āhu
etadariyānamuttamaṃ	etad + ariyānaṃ + uttamaṃ
visuddhimāhu	visuddhiṃ + āhu
pasaṃsamicchaṃ	pasaṃsaṃ + icchaṃ
parihīnamāhu	parihīnaṃ + āhu
abhigajjameti	abhigajjaṃ + eti
paṭisūramicchaṃ	paṭisūraṃ + icchaṃ
diṭṭhimuggayha	diṭṭhiṃ + uggayha
sampayātaveti	sampayātave + iti
pavitakkamāgamā	pavitakkaṃ + āgamā
bhavūpapattiñca	bhavūpapattiṃ + ca
sīlavatānujīvitaṃ	sīlavataṃ + anujīvitaṃ
māgaṇḍiyāti	māgaṇḍiya + iti
māgandiyāti	māgandiya + iti
passañca	passaṃ + ca
momuhameva	momuhaṃ + eva
aṇumpi	aṇuṃ + api
canūpalittaṃ	ca + anūpalittaṃ
piyānu	piyā + nu
dvayameva	dvayaṃ + eva
mamattamatthi	mamattaṃ + atthi
upanissitāti	upanissitā + iti
paṭikkosamakevalī	paṭikkosaṃ + akevalī
sakaṃsakaṃdiṭṭhiparibbasānā	sakaṃsakaṃ + diṭṭhiparibbasānā
dhammamanānujānaṃ	dhammaṃ + anānujānaṃ
sabbevime	sabbe + eva + ime
sakaṃsakaṃdiṭṭhimakaṃsu	sakaṃsakaṃ + diṭṭhiṃ + akaṃsu
kapīva	kapi + iva
ettāvataggampi	ettāvatā + aggaṃ + api
takkamanussaranti	takkaṃ + anussaranti
dvayadhammamāhu	dvayadhammaṃ + āhu
sayamattanā	sayaṃ + attanā
yābhivadanti	yā + abhivadanti
suddhimakevalī	suddhiṃ + akevalī
suddhimakevalīno	suddhiṃ + akevalīno
tyābhirattā	te + abhirattā
medhagamāvaheyya	medhagaṃ + āvaheyya
nindamanvānayanti	nindaṃ + anvānayanti
pasaṃsampi	pasaṃsaṃ + api
kimeyya	kiṃ + eyya
khantimakubbamāno	khantiṃ + akubbamāno
saññamenāhu	saññamena + āhu
satthāva	satthā + iva
santimanuggahāya	santiṃ + anuggahāya
suddhimanutthunanti	suddhiṃ + anutthunanti
panāhu	pana + āhu
paripuṇṇamāhu	paripuṇṇaṃ + āhu
sammutimāhu	sammutiṃ + āhu
paraneyyamatthi	paraneyyaṃ + atthi
dhammamaññaṃ	dhammaṃ + aññaṃ
tathaddasā	tatha + addasā
abhabbuppattikāni	abhabba + uppattikāni
munīdha	muni + idha
dhammamabhijaññā	dhammaṃ + abhijaññā
ajjhattamevupasame	ajjhattaṃ + eva + upasame
santimeseyya	santiṃ + eseyya
annānamatho	annānaṃ + atho
athāsanesu	atha + āsanesu
nāññamatimaññe	nāññaṃ + atimaññe
santīti	santi + iti
sakkhidhammamanītihamadassī	sakkhidhammaṃ + anītihaṃ + adassī
bhayamāvisi	bhayaṃ + āvisi
bhavanamattano	bhavanaṃ + attano
osānetveva	osāne + iti + eva
sallamaddakkhiṃ	sallaṃ + addakkhiṃ
sallamabbuyha	sallaṃ + abbuyha
sikkhānukiriyanti	sikkhā + anugīyanti
tamānisaṃsaṃ	taṃ + ānisaṃsaṃ
nirassatīti	nirassati + iti
dutīyamatthi	dutīyaṃ + atthi
atisāradiṭṭhiyāva	atisāradiṭṭhiyā + eva
bālamasuddhidhammaṃ	bālaṃ + asuddhidhammaṃ
sāvajjanavajjametaṃ	sāvajjanavajjaṃ + etaṃ
saddhammapūjāpi	saddhammapūjā + api
samantamasāro	samantaṃ + asāro
sikkhānugīyanti	sikkhā + anugīyanti
gaṇimāgato	gaṇiṃ + āgato
ratimajjhagā	ratiṃ + ajjhagā
gaṇimāgataṃ	gaṇiṃ + āgataṃ
rittamāsanaṃ	rittaṃ + āsanaṃ
kyāssassu	kiṃ + assa + assu
sīlabbatānāssu	sīlabbatāni + assu
paradhammikānampi	paradhammikānaṃ + api
yadāvilattaṃ	yad + āvilattaṃ
athappiyaṃ	atha + piyaṃ
kudha	ko + idha
soyevattho	so + eva + attho
satimābhinande	satiṃ + abhinande
mahāyaññamakappayi	mahāyaññaṃ + akappayi
vacanamabravi	vacanaṃ + abravi
ñāṇamettha	ñāṇaṃ + ettha
manasāyeva	manasā + eva
tasitovudakaṃ	tasito + iva + udakaṃ
mahālābhaṃva	mahālābhaṃ + iva
pabbatamāruhuṃ	pabbataṃ + āruhuṃ
sataraṃsīva	sataraṃsī + iva
nāmanighaṇḍurukkhādīnaṃ	nāma + nighaṇḍu + rukkha + ādīnaṃ
kametaṃ	kaṃ + etaṃ
vanasavhayaṃ	vanasa + avhayaṃ
kissābhilepanaṃ	kiṃ + assa + abhilepanaṃ
jappābhilepanaṃ	jappā + abhilepanaṃ
paññāyete	paññāya + ete
katthetaṃ	kattha + etaṃ
manasānāvilo	manasā + anāvilo
ubhantamabhiññāya	ubhantaṃ + abhiññāya
sibbinimaccagā	sibbiniṃ + accagā
puṇṇakāti	puṇṇaka + iti
kāmābhijappanti	kāma + abhijappanti
mettagūti	mettagū + iti
etābhinandāmi	etaṃ + abhinandāmi
nūnappajaheyyu	nūna + pajaheyyu
saṅgamimaṃ	saṅgaṃ + imaṃ
tenahātappaṃ	tena + hi + ātappaṃ
dhotakāti	dhotaka + iti
brāhmaṇamiriyamānaṃ	brāhmaṇaṃ + iriyamānaṃ
ākāsova	ākāso + iva
upasīvāti	upasīva + iti
pūgampi	pūgaṃ + api
pamāṇamatthi	pamāṇaṃ + atthi
vādapathāpi	vādapathā + api
sabbeti	sabbe + iti
nandāti	nanda + iti
nivutāti	nivutā + iti
anekarūpampi	anekarūpaṃ + api
oghatiṇṇāti	oghatiṇṇā + iti
dhammamakkhāhi	dhammaṃ + akkhāhi
nibbānapadamaccutaṃ	nibbānapadaṃ + accutaṃ
todeyyāti	todeyya + iti
dīpamakkhāhi	dīpaṃ + akkhāhi
paddhagūti	paddhagū + iti
vīramakāmakāmiṃ	vīraṃ + akāmakāmiṃ
āsavāssa	āsavā + assa
bhadrāvudhāti	bhadrāvudha + iti
udayāti	udaya + iti
sakkānupucchāmi	sakka + anupucchāmi
posālāti	posāla + iti
tiṭṭhantamenaṃ	tiṭṭhantaṃ + enaṃ
piṅgiyāti	piṅgiya + iti
kiñcanamatthi	kiñcanaṃ + atthi
jatukaṇṇīti	jatukaṇṇi + iti
nattamahābhipassa	nattamahaṃ + abhipassa
pārāyanamanugāyissaṃ	pārāyanaṃ + anugāyissaṃ
yathāddakkhi	yathā + addakkhi
tathākkhāsi	tathā + akkhāsi
pahīnamalamohassa	pahīna + mala + mohassa
mānamakkhappahāyino	māna + makkha + pahāyino
sabbabhavātivatto	sabbabhavaṃ + ativatto
kānanamāvaseyya	kānanaṃ + āvaseyya
taṇhakkhayamanītikaṃ	taṇhakkhayaṃ + anītikaṃ
cakkhunāva	cakkhunā + iva
pañhānantakaro	pañhānaṃ + antakaro
paṭhamakaṭṭhavaro	paṭhamaka + aṭṭha + varo
hirimaṅgalanāmo	hiri + maṅgala + nāmo
kāmaguhaṭṭhakaduṭṭhakanāmā	kāma + guhaṭṭhaka + duṭṭhaka + nāmā
mettiyavaro	mettiya + varo
dhammamadāsi	dhammaṃ + adāsi
parakhemajaniyaṃ	para + khema + janiyaṃ
suttavaraṃ	sutta + varaṃ
byañjanamatthapadaṃ	byañjanaṃ + atthapadaṃ
rāgavirāgamanejamasokaṃ	rāgavirāgaṃ + anejaṃ + asokaṃ
taṇhāratacchadanatāṇalatāpamokkhaṃ	taṇhārata + chadana + tāṇa + latā + pamokkhaṃ
taṇhātalaratacchedanatāṇapamokkhaṃ	taṇhā + tala + rata + chedana + tāṇa + pamokkhaṃ
aṇṇavamūpamaratanasucittaṃ	aṇṇavaṃ + upama + ratana + sucittaṃ
ravimūpamatejaṃ	raviṃ + upama + tejaṃ
maccutatāṇaparaṃ	m + accuta + tāṇa + paraṃ
evampahaṃ	evaṃ + api + ahaṃ
kiṃpattinamāhu	kiṃ + pattinaṃ + āhu
nāpentime	nāpenti + ime
sataraṃsiṃva	sataraṃsiṃ + iva
uddhaṃsa	uddhaṃ + sa
sayaṃva	sayaṃ + eva
viriyavāso	viriyavā + so
haññadatthatthi	hi + añña + attha + atthi
kuppapaṭiccasantiṃ	kuppapaṭicca + santiṃ
mupāgamuṃ	m + upāgamuṃ
diṭṭhimakaṃsu	diṭṭhiṃ + akaṃsu
manusāsati	m + anusāsati
viriyavāti	viriyavā + iti
tamanudāsino	tamanudo + āsino
sammāparibbājanīyopi	sammāparibbājanīyo + api
puṭṭhumakāmamāgamaṃ	puṭṭhuṃ + akāmaṃ + āgamaṃ
pārāyananteva	pārāyanaṃ + iti + eva
dasamāsaccayena	dasamāsa + accayena
ādīnavavibhāvanatthameva	ādīnava + vibhāvana + atthaṃ + eva
idamajaramidamamaraṃ	idaṃ + ajaraṃ + idaṃ + amaraṃ
aviraddhoyevāsīti	aviraddho + eva + asi + iti
tatopaññena	tato + api + aññena
suññatānimittasamāpattiyova	suññatā + animitta + samāpattiyo + eva
palāpettha	palāpo + ettha
vānurakkhituṃ	vā + anurakkhituṃ
cetehi	ca + etehi
conatā	ca + onatā
manti	maṃ + iti
padānupubbatāpetaṃ	pada + anupubbatā + api + etaṃ
hupeyyapāvusoti	hupeyya + api + āvuso + iti
sīhānaṃva	sīhānaṃ + iva
imamatthamabhāsisuṃ	imaṃ + atthaṃ + abhāsisuṃ
dumapattaṃva	dumapattaṃ + iva
dhitimāti	dhitimā + iti
nirāmiseti	nirāmise + iti
subbatāti	subbatā + iti
nigacchasīti	nigacchasi + iti
ariyamaṭṭhaṅgikamañjasaṃ	ariyaṃ + aṭṭhaṅgikaṃ + añjasaṃ
sāmaññamakiñcanassāti	sāmaññaṃ + akiñcanassa + iti
vedhīti	vedhī + iti
tuyhāpadāne	tuyhaṃ + apadāne
katāti	katā + iti
sīlameva	sīlaṃ + eva
dullabhanti	dullabhaṃ + iti
gatamāyusaṅkhayaṃ	gataṃ + āyusaṅkhayaṃ
bālampi	bālaṃ + api
sīhappamatto	sīha + appamatto
bhagavānusāsati	bhagavā + anusāsati
pāṇitaleva	pāṇitale + eva
mahogheva	mahogho + eva
visaṃhatāti	visaṃhatā + iti
mayajja	mayā + ajja
sesakenamhi	sesakena + amhi
parinibbissatyanāsavoti	parinibbissati + anāsavo + iti
santhavanti	santhavaṃ + iti
tūlamiva	tūlaṃ + iva
pilavatīva	pilavati + iva
tvevānatthasaṃhitaṃ	tu + eva + anatthasaṃhitaṃ
tathāhayaṃ	tathā + hi + ayaṃ
vaneti	vane + iti
kalyatanti	kalyataṃ + iti
mahāmunīti	mahāmuni + iti
satatamaniccatanti	satataṃ + aniccataṃ + iti
samaṇasādhutāti	samaṇasādhutā + iti
papañca	papaṃ + ca
abhisattova	abhisatto + iva
aññamiva	aññaṃ + iva
vanasavhayo	vana + savhayo
ekakeva	ekake + eva
mahesibhīti	mahesibhi + iti
bhavenamhi	bhavena + amhi
niggahītosi	niggahīto + asi
chavasittova	chavasitto + eva
dhammamassosiṃ	dhammaṃ + assosiṃ
kaṅkhamabhijānāmi	kaṅkhaṃ + abhijānāmi
mahiddhikāti	mahiddhikā + iti
satimāti	satimā + iti
pakubbatīti	pakubbati + iti
janamevassito	janaṃ + eva + assito
pahāyānappake	pahāya + anappake
ratinti	ratiṃ + iti
kappasatānāhaṃ	kappasatāni + ahaṃ
maggamakkhāhi	maggaṃ + akkhāhi
gaṅgāsotova	gaṅgāsoto + iva
ādāsamādāya	ādāsaṃ + ādāya
ñāṇadassanamattano	ñāṇadassanaṃ + attano
orasanti	orasaṃ + iti
anāsavanti	anāsavaṃ + iti
carimoyaṃ	carimo + ayaṃ
kassindriyāni	kassa + indriyāni
mayhindriyāni	mayhaṃ + indriyāni
cattavaṇṇaṃ	ca + attavaṇṇaṃ
uttamamaccutaṃ	uttamaṃ + accutaṃ
nandamānāgataṃ	nandamānaṃ + āgataṃ
sūlamāropamānakaṃ	sūlaṃ + āropamānakaṃ
mānatthe	mā + anatthe
saññamalabhiṃ	saññaṃ + alabhiṃ
pañcāhāhaṃ	pañcāhaṃ + ahaṃ
manutappati	m + anutappati
bhāvayeti	bhāvaye + iti
brahmacariyānuciṇṇena	brahmacariyaṃ + anuciṇṇena
saṅgāmasīseva	saṅgāmasīse + iva
kittitāti	kittitā + iti
maccupāsaṃva	maccupāsaṃ + iva
iriyantyamarā	iriyanti + amarā
māsādesi	mā + āsādesi
abandhanāti	abandhanā + iti
tassatthā	tassa + atthā
virujjhatīti	virujjhati + iti
puttamādāya	puttaṃ + ādāya
ālayamālayesinī	ālayaṃ + ālayesinī
bhijjatuyaṃ	bhijjatu + ayaṃ
naveva	nava + eva
andhova	andho + iva
tavantike	tava + antike
divasassahaṃ	divasassa + ahaṃ
dānīdha	dāni + idha
lūkhampi	lūkhaṃ + api
kānaneti	kānane + iti
gajova	gajo + iva
navaggahamaṅkusaggaho	navaggahaṃ + aṅkusaggaho
bījaṃva	bījaṃ + iva
samuddova	samuddo + iva
vivekamanubrūhayanti	vivekamanubrūhayaṃ + iti
samunnamayamattānaṃ	samunnamayaṃ + attānaṃ
saṃgāmasīseva	saṃgāmasīse + iva
padhaṃsayīti	padhaṃsayi + iti
bhariyāyānitāya	bhariyāya + ānitāya
paṭivijjhahanti	paṭivijjhi + ahaṃ + iti
esāvahiyyase	eso + avahiyyase
dadhithālakaṃva	dadhithālakaṃ + iva
hatthikkhandhāvapatitaṃ	hatthikkhandhā + avapatitaṃ
sakkāyādhigatā	sakkāyaṃ + adhigatā
yathaññe	yathā + aññe
nayakovidāti	nayakovidā + iti
mūsikasobbhaṃva	mūsikasobbhaṃ + iva
tesaññataroyamāyuvā	tesaṃ + aññataro + ayaṃ + āyuvā
sabbapāṇānukampati	sabbapāṇe + anukampati
assaddhānīdha	assaddhānaṃ + idha
rajojallamadhārayiṃ	rajojallaṃ + adhārayiṃ
mahājutimanāsavaṃ	mahājutiṃ + anāsavaṃ
leṇamaleṇadassinī	leṇaṃ + aleṇadassinī
surammāti	surammā + iti
kalīva	kalī + iva
āṇidvāreva	āṇidvāre + iva
selaguhāyaṃva	selaguhāyaṃ + iva
kathamahaṃ	kathaṃ + ahaṃ
buddhamappameyyaṃ	buddhaṃ + appameyyaṃ
dhammamappameyyaṃ	dhammaṃ + appameyyaṃ
saṅghamappameyyaṃ	saṅghaṃ + appameyyaṃ
abhivuṭṭhaṃva	abhivuṭṭhaṃ + iva
khuramādāya	khuraṃ + ādāya
chettumattano	chettuṃ + attano
jātijarātivattate	jātijarā + ativattate
vijjateva	vijjati + eva
maggametaṃ	maggaṃ + etaṃ
vārināva	vārinā + iva
latāva	latā + iva
aṅgārakāsuṃva	aṅgārakāsuṃ + iva
tapantamiva	tapantaṃ + iva
madañca	madaṃ + ca
hatāti	hatā + iti
niccamattāṇo	niccaṃ + attāṇo
pādukāruyha	pādukā + āruyha
yuvāsi	yuvā + asi
harāmahaṃ	harāmi + ahaṃ
bhaddova	bhaddo + iva
ramanteke	ramanti + eke
bhaddāti	bhadda + iti
dhammasudhammatāti	dhammasudhammatā + iti
yesāyaṃ	yesu + ayaṃ
lābhāti	lābhā + iti
cābravi	ca + abravi
kuṭimacchisaṃ	kuṭiṃ + acchisaṃ
cakkhumāssa	cakkhumā + assa
paññavāssa	paññavā + assa
paṭhamamaddakkhiṃ	paṭhamaṃ + addakkhiṃ
cetosantimanajjhagaṃ	cetosantiṃ + anajjhagaṃ
sudīpamattano	sudīpaṃ + attano
acārihaṃ	acāriṃ + ahaṃ
udakakumbhamādāya	udakakumbhaṃ + ādāya
pattadaṇḍova	pattadaṇḍo + iva
baḷiseneva	baḷisena + iva
hessatyājāniyo	hessati + ājāniyo
vittavāpi	vittavā + api
byantikatova	byantikato + eva
accimantova	accimanto + iva
nevātisītaṃ	na + eva + atisītaṃ
sakkati	sakka + iti
tayābhijāto	tayā + abhijāto
aṅgīrasassappaṭimassa	aṅgīrasassa + appaṭimassa
ayyakosīti	ayyako + asi + iti
sādhayissāmahaṃyeva	sādhayissāmi + ahaṃ + eva
nadiṃva	nadiṃ + iva
candanikaṃva	candanikaṃ + iva
navamaṃsapesisatānulittoti	nava + maṃsapesi + sata + anulitto + iti
yemaṃ	ye + imaṃ
parinibbissantināsavāti	parinibbissanti + anāsavā + iti
āgacchantaggikhandhāva	āgacchantā + aggikhandhā + iva
phalamāsamāno	phalaṃ + āsamāno
nisīdambavane	nisīdiṃ + ambavane
nisīdahaṃ	nisīdiṃ + ahaṃ
gūthalittaṃva	gūthalittaṃ + iva
nibbutiñcādhigacchatīti	nibbutiṃ + ca + adhigacchti + iti
yañcettha	yaṃ + ca + ettha
aṭṭhaṅgamaggamariyaṃ	aṭṭhaṅgamaggaṃ + ariyaṃ
uppādayateva	uppādayati + eva
ekādaseva	ekādasa + eva
sīlamevidha	sīlaṃ + eva + idha
saññamenādhigacchati	saññamena + adhigacchati
pāpamācaraṃ	pāpaṃ + ācaraṃ
sīlamābharaṇaṃ	sīlaṃ + ābharaṇaṃ
kavacamabbhutaṃ	kavacaṃ + abbhutaṃ
sambalamevaggaṃ	sambalaṃ + eva + aggaṃ
ahamāyāciṃ	ahaṃ + āyāciṃ
pubbajātimanussariṃ	pubbajātiṃ + anussariṃ
brāhmaṇamuttamanti	brāhmaṇaṃ + uttamaṃ + iti
nibbānamabhihāraye	nibbānaṃ + abhihāraye
dīghamantare	dīghaṃ + antare
āmodayāmahaṃ	āmodayāmi + ahaṃ
abbhamattaṃva	abbhamattaṃ + iva
sampādethappamādena	sampādetha + appamādena
ariyadhammova	ariyadhammo + eva
sibbinimaccagū	sibbiniṃ + accagū
indakhīlova	indakhīlo + iva
garahāva	garahā + eva
parinibbantināsavāti	parinibbanti + anāsavā + iti
rogānamiva	rogānaṃ + iva
pitvāva	pitvā + iva
pītvāva	pītvā + iva
ādittāva	ādittā + iva
sutattaṃva	sutattaṃ + iva
sāsanamāgamma	sāsanaṃ + āgamma
kimānupubbaṃ	kiṃ + ānupubbaṃ
indriyāneva	indriyāni + eva
tittakaggamanussaraṃ	tittakaggaṃ + anussaraṃ
samuggamiva	samuggaṃ + iva
khuraṃva	khuraṃ + iva
tesamāvaraṇaṃ	tesaṃ + āvaraṇaṃ
paresamabhijigīsati	paresaṃ + abhijigīsati
indriyānindriyeheva	indriyāni + indriyehi + eva
vatātāpī	vata + ātāpī
ghasamāmisaṃ	ghasaṃ + āmisaṃ
dvedhāpannarasāyutaṃ	dvedhā + pannarasāyutaṃ
hadayeti	hadaye + iti
sallamabbhantarapassayaṃ	sallaṃ + abbhantarapassayaṃ
rahadehamasmi	rahade + ahaṃ + asmi
thinamiddhamapatthaṭe	thinamiddhaṃ + patthaṭe
mabravi	me + abravi
maggamaddakkhiṃ	maggaṃ + addakkhiṃ
titthamaddakkhimuttamaṃ	titthaṃ + addakkhiṃ + uttamaṃ
cirarattamadhiṭṭhitaṃ	cirarattaṃ + adhiṭṭhitaṃ
mepānudī	me + apānudī
evamācinato	evaṃ + ācinato
dantāmha	dantā + amha
sojja	so + ajja
ṭṭhitomhi	ṭhito + amhi
tuvamaṭṭhitosi	tuvaṃ + aṭṭhito + asi
pabbajjamayāci	pabbajjaṃ + ayāci
suddhimajjhagaṃ	suddhiṃ + ajjhagaṃ
suddhamajjhagā	suddhaṃ + ajjhagā
niccamāraddhavīriyo	niccaṃ + āraddhavīriyo
nippapañcamadesayi	nippapañcaṃ + adesayi
tiriñcati	ti + riñcati
tiriñcati	iti + riñcati
udakāsanabhojanaṃ	udaka + āsana + bhojanaṃ
nānappayātamhi	nānā + payātamhi
phussasavhayaṃ	phussa + savhayaṃ
aññamaññamagāravā	aññamaññaṃ + agāravā
uppajjissantyanāgate	uppajjissanti + anāgate
guṇahīnāpi	guṇahīnā + api
vatthumajeḷakaṃ	vatthuṃ + ajeḷakaṃ
sādiyissantyanāgate	sādiyissanti + anāgate
carissantyariyā	carissanti + ariyā
nāgassāsi	nāgassa + āsi
niggaṇhissantyanāgate	niggaṇhissanti + anāgate
sikkhāpentāpi	sikkhāpentā + api
sotamodhesimatthiko	sotaṃ + odhesiṃ + atthiko
rukkhamūlaṃva	rukkhamūlaṃ + eva
upatissova	upatisso + eva
maraṇameva	maraṇaṃ + eva
sutenātimaññati	sutena + atimaññati
andhakāraṃva	andhakāraṃ + iva
selamāruyha	selaṃ + āruyha
anattaneyyametaṃ	anattaneyyaṃ + etaṃ
cetosamathamanuttaṃ	cetosamathaṃ + anuttaṃ
nāgaṃva	nāgaṃ + iva
iṇaṭṭova	iṇaṭṭo + iva
āṇākhettaṃ	āṇā + khettaṃ
vimalaṃva	vimalaṃ + iva
maccujarāyupaddutaṃ	maccujarāya + upaddutaṃ
tikhiṇamasiṃ	tikhiṇaṃ + asiṃ
ajjhattikāneva	ajjhattikāni + eva
patareyyamiddhiyā	patareyyaṃ + iddhiyā
calamiti	calaṃ + iti
kapālahatthova	kapālahattho + eva
nibbānamevābhimano	nibbānaṃ + eva + abhimano
tiracchānagatāpi	tiracchānagatā + api
ummattakeneva	ummattakena + iva
pakateva	pakati + eva
gajaṃva	gajaṃ + iva
yoggācariyova	yoggācariyo + iva
gāmaṇḍalaṃva	gāmaṇḍalaṃ + iva
gūthaṭṭhānaṃva	gūthaṭṭhānaṃ + iva
paṅkamhiva	paṅkamhi + iva
tadākāsasamaṃ	tad + ākāsasamaṃ
aggikhandhaṃva	aggikhandhaṃ + iva
nibbānamadhigantabbaṃ	nibbānaṃ + adhigantabbaṃ
vandanāyetaṃ	vandanā + etaṃ
māsādi	mā + āsādi
māttānaṃ	mā + attānaṃ
kummaggamanudhāvati	kummaggaṃ + anudhāvati
kimīva	kimi + iva
puṇḍarīkaṃva	puṇḍarīkaṃ + iva
saṅkhārenupalippati	saṅkhāre + nupalippati
bālova	bālo + iva
sukhañcānubhoti	sukhaṃ + ca + anubhoti
ekasattatītisaṅkhyā	ekasattati + iti + saṅkhyā
theragāthāṭṭhakathā	theragāthā + aṭṭhakathā
uṭṭhahatīti	uṭṭhahati + iti
asitaṃva	asitaṃ + iva
namassamanusikkhe	namassaṃ + anusikkhe
vītamalova	vītamalo + iva
bodhimajjhagamā	bodhiṃ + ajjhagamā
kaccissataṃ	kacci + assa + taṃ
ekasattatīti	ekasattati + iti
aggikhandhāva	aggikhandhā + iva
nibbutāti	nibbutā + iti
piṇḍapātamatikkanto	piṇḍapātaṃ + atikkanto
ubbhamāhu	ubbhaṃ + ahu
samaṇaṭṭhitomhi	samaṇa + ṭhito + amhi
ujjuhānova	ujjuhāno + iva
sasaṅgāmeva	sasaṅgāme + eva
sayantuttānaseyyakā	sayanti + uttānaseyyakā
gaṇikāva	gaṇikā + iva
padīpadhārova	padīpadhāro + iva
dhammaviññāṇamākaṅkhaṃ	dhammaviññāṇaṃ + ākaṅkhaṃ
vassupetova	vassupeto + iva
gaganāvabbhachāditā	gaganā + iva + abbhachāditā
sahasādiyitvā	sahasā + ādiyitvā
vighātudayameva	vighātudayaṃ + eva
vivaramanupabhanti	vivaraṃ + anupabhanti
sālikāyiva	sālikāya + iva
meghopasammaye	megho + upasammaye
paralābhopajīvantā	paralābhaṃ + upajīvantā
natavedisaṃ	na + tava + edisaṃ
abhumme	abhuṃ + me
sayissanti	sayissaṃ + iti
padālayāti	padālaya + iti
samappitāti	samappitā + iti
yogakkhemamanuttaranti	yogakkhemaṃ + anuttaraṃ + iti
muttāmhi	muttā + amhi
sītibhūtāmhi	sītibhūtā + amhi
sītibhūtāsi	sītibhūtā + asi
upasantāmhi	upasantā + amhi
aḍḍhenagghaṃ	aḍḍhena + agghaṃ
nibbindahaṃ	nibbindiṃ + ahaṃ
virajjahaṃ	virajjiṃ + ahaṃ
sājja	sā + ajja
visositāti	visositā + iti
suññatassānimittassa	suññatassa + animittassa
lābhinīhaṃ	lābhinī + ahaṃ
aṅkusamādāya	aṅkusaṃ + ādāya
pādanti	pādaṃ + iti
nāgamāruhi	nāgaṃ + āruhi
jīvāti	jīva + iti
etamhāḷāhane	etamhi + āḷāhane
kamanusocasi	kaṃ + anusocasi
kiṃme	kiṃ + ime
pītāva	pītā + iva
valāhakamivaddhagū	valāhakaṃ + iva + addhagū
pappotumitthiyā	pappotuṃ + itthiyā
tyamha	te + amha
sītibhūtamha	sītibhūtā + amha
mebhiññā	me + abhiññā
oruhāmihaṃ	oruhāmi + ahaṃ
bhuñjahaṃ	bhuñjiṃ + ahaṃ
patthanāpi	patthanā + api
hīnamatthaṃ	hīnaṃ + atthaṃ
yathābhūtamavekkhantī	yathābhūtaṃ + avekkhantī
vasantīhaṃ	vasantī + ahaṃ
maggamañjasaṃ	maggaṃ + añjasaṃ
bhaddeti	bhadde + iti
abhuñjahaṃ	abhuñjiṃ + ahaṃ
cāvajjadassinī	ca + avajjadassinī
bhadraṃvajāniyaṃ	bhadraṃ + iva + ājāniyaṃ
padīpasseva	padīpassa + iva
pubbajātimanussaruṃ	pubbajātiṃ + anussaruṃ
tevijjāmha	tevijjā + amha
duggatāhaṃ	duggatā + ahaṃ
tevijjāmhi	tevijjā + amhi
cāgataṃ	ca + āgataṃ
khossa	kho + assa
tatāgacchi	tato + āgacchi
itopi	ito + api
sambuddhamakutobhayaṃ	sambuddhaṃ + akutobhayaṃ
yathābhuccamajānantā	yathābhuccaṃ + ajānantā
suddhimamaññatha	suddhiṃ + amaññatha
uyyānamabhihārayiṃ	uyyānaṃ + abhihārayiṃ
yathābhuccamajānantī	yathābhuccaṃ + ajānantī
sakkāyadiṭṭhimeva	sakkāyadiṭṭhiṃ + eva
paripucchahaṃ	paripucchiṃ + ahaṃ
sakkaṃva	sakkaṃ + iva
sādhumuttāmhi	sādhumuttā + amhi
sādhumuttikāmhi	sādhumuttikā + amhi
khambhesimattānaṃ	khambhesiṃ + attānaṃ
nikkhipissāmimaṃ	nikkhipissāmi + imaṃ
abbūḷhasallāhaṃ	abbūḷhasallā + ahaṃ
cittassūpasamajjhagaṃ	cittassūpasamaṃ + ajjhagaṃ
pāsamivoḍḍiya	pāsaṃ + iva + oḍḍiya
namassihaṃ	namassiṃ + ahaṃ
bujjhihaṃ	bujjhiṃ + ahaṃ
ummaggapaṭipannāmhi	ummaggapaṭipannā + amhi
anantarāvimokkhāsiṃ	anantarāvimokkhā + āsiṃ
okassayāmahaṃ	okassayāmi + ahaṃ
vicārihaṃ	vicāriṃ + ahaṃ
addasāhaṃ	addasaṃ + ahaṃ
appattāva	appattā + eva
amatamadhigacchiṃ	amataṃ + adhigacchiṃ
apekkhihaṃ	apekkhiṃ + ahaṃ
karissaseko	karissasi + eko
vasībhūtāhaṃ	vasībhūtā + ahaṃ
udakamāhariṃ	udakaṃ + āhariṃ
puññampimā	puññaṃ + api + imā
nāhamicchāmi	na + ahaṃ + icchāmi
ajjamhi	ajja + amhi
vāsitova	vāsito + iva
jarāyatha	jarāya + atha
kānanaṃva	kānanaṃ + iva
sampaṭivijjhahaṃ	sampaṭivijjhiṃ + ahaṃ
dhammasaṃvegamāpādiṃ	dhammasaṃvegaṃ + āpādiṃ
sapattikampi	sapattikaṃ + api
nettahesumabhinīlamāyatā	nettā + ahesuṃ + abhinīlamāyatā
uddhaṃsotāti	uddhaṃsotā + iti
kokilāva	kokilā + iva
thevikīva	thevikī + iva
kañcanassaphalakaṃva	kañcanassa + phalakaṃ + iva
bahudukkhānamālayo	bahudukkhānaṃ + ālayo
samaṇāneva	samaṇānaṃ + eva
samaṇānameva	samaṇānaṃ + eva
pahīnesaṃ	pahīnaṃ + esaṃ
anapekkhāva	anapekkhā + eva
pariniṭṭhitamesānā	pariniṭṭhitaṃ + esānā
amhampi	amhaṃ + api
puttamatosayi	puttaṃ + atosayi
kāḷaṅginiṃva	kāḷa + aṅginiṃ + iva
sākuntikova	sākuntiko + iva
chetvāva	chetvā + iva
labbhamamhehi	labbhaṃ + amhehi
rathamādāya	rathaṃ + ādāya
hotvassaratho	hotu + assaratho
sundarimāyantiṃ	sundariṃ + āyantiṃ
dhītāmhi	dhītā + amhi
daharāhaṃ	daharā + ahaṃ
aratimajjhagaṃ	aratiṃ + ajjhagaṃ
dhammamassuṇiṃ	dhammaṃ + assuṇiṃ
nekkhammameva	nekkhammaṃ + eva
pahāyahaṃ	pahāya + ahaṃ
sāpateyyamanappakaṃ	sāpateyyaṃ + anappakaṃ
madanañcetaṃ	madanaṃ + ca + etaṃ
amittāva	amittā + iva
vinītuppalavaṇṇāya	vinītā + uppalavaṇṇāya
abhigajjantiva	abhigajjanti + iva
tapanīyakatāva	tapanīyakatā + iva
cittalateva	cittalate + iva
iṅgālakuyāva	iṅgālakuyā + iva
saṅkhatamasubhanti	saṅkhataṃ + asubhaṃ + iti
sabbattheva	sabbattha + eva
supinanteva	supinante + iva
evamanuyuñjiyamānā	evaṃ + anuyuñjiyamānā
kucchimokkamiṃ	kucchiṃ + okkamiṃ
akhalitamabhayaṃ	akhalitaṃ + abhayaṃ
kheḷassuccārassava	kheḷassuccārassa + eva
puttamanurakkhamānā	puttaṃ + anurakkhamānā
bodhīti	bodhī + iti
pāsādikāsi	pāsādikā + asi
athāsi	atha + asi
nekkhammamanuyuttā	nekkhammaṃ + anuyuttā
yathāmhi	yathā + amhi
tassamhi	tassa + amhi
suṇhamadāsi	suṇhaṃ + adāsi
tamekavarakampi	taṃ + ekavarakaṃ + api
sāmikamupemi	sāmikaṃ + upemi
ādāsakañca	ādāsakaṃ + ca
añjaniñca	añjaniṃ + ca
mātarañca	mātaraṃ + ca
āpucchahaṃ	āpucchā + ahaṃ
ekagharepahaṃ	ekaghare + api + ahaṃ
cahaṃ	ca + ahaṃ
dessāva	dessā + eva
āpucchāhaṃ	āpucchā + ahaṃ
apucchāhaṃ	apucchā + ahaṃ
napihaṃ	na + api + ahaṃ
kātuyye	kātuṃ + ayye
jitāmhase	jitā + amhase
dāsīva	dāsī + iva
ghaṭikañca	ghaṭikaṃ + ca
mallakañca	mallakaṃ + ca
uṭṭhāyāsanaṃ	uṭṭhāya + āsanaṃ
bhojanamadāsiṃ	bhojanaṃ + adāsiṃ
yassayaṃ	yassa + ayaṃ
kimināvaṭṭo	kiminā + eva + aṭṭo
naṅgalamahaṃ	naṅgalaṃ + ahaṃ
sakaṭañca	sakaṭaṃ + ca
andhovaṭṭo	andho + eva + aṭṭo
taṃsaṃvaṇṇanāyampi	taṃsaṃvaṇṇanāyaṃ + api
orundhatassa	orundhati + assa
nibbānābhiratāhaṃ	nibbānābhiratā + ahaṃ
gatāva	gatā + eva
dinnāsi	dinnā + asi
āṇādhanamissariyaṃ	āṇādhanaṃ + issariyaṃ
daharikāsi	daharikā + asi
bhavagatamasāraṃ	bhavagataṃ + asāraṃ
pūtikāyamasuciṃ	pūtikāyaṃ + asuciṃ
kheḷassuccārapassavaparipuṇṇe	kheḷassuccāra + api + assava + paripuṇṇe
abbhantaramassa	abbhantaraṃ + assa
sakāpi	sakā + api
viññāyevaṃ	viññāya + evaṃ
tātabhinikkhamissaṃ	tāta + abhinikkhamissaṃ
tālavatthukatā	tāla + avatthukatā
pāsādeva	pāsāde + eva
kāmabhoginamaggo	kāmabhoginaṃ + aggo
ayoguḷova	ayoguḷo + iva
khandhāsaṃ	khandhā + āsaṃ
phalibhañjanaṭṭhena	phali + bhañjana + aṭṭhena
apāpuritvānahaṃ	apāpuritvāna + ahaṃ
ekakappamaṭṭhīnaṃ	ekakappaṃ + aṭṭhīnaṃ
dālimalaṭṭhiṃva	dālimalaṭṭhiṃ + iva
sakesaṅgesu	sakesu + aṅgesu
viddesanamakāsiṃ	viddesanaṃ + akāsiṃ
antodīpeva	antodīpe + iva
puthulomova	puthulomo + iva
sunakhova	sunakho + iva
sunakhaṃva	sunakhaṃ + iva
padamasokaṃ	padaṃ + asokaṃ
asapattamasambādhaṃ	asapattaṃ + asambādhaṃ
adhigatamidaṃ	adhigataṃ + idaṃ
labhanīyamidaṃ	labhanīyaṃ + idaṃ
acchariyamabbhutaṃ	acchariyaṃ + abbhutaṃ
theriyekuttarasatā	theriya + ekuttara + satā
therīyekuttarachasatā	therīya + ekuttara + cha + satā
tiṃsamattāpi	tiṃsamattaṃ + api
pañcasatamattāpi	pañcasatamattā + api
āsavakkhayāti	āsavakkhayā + iti
dhanamissariyaṃ	dhanaṃ + issariyaṃ
yācatassā	yācati + assā
pajjalitaṃva	pajjalitaṃ + iva
kaṅkaṇaṃva	kaṅkaṇaṃ + iva
phalakaṃva	phalakaṃ + iva
saṅkhamuttāva	saṅkhamuttā + iva
nayanti	nayaṃ + iti
jīvanti	jīvaṃ + iti
jinanti	jinaṃ + iti
upāyāsāsiṃ	upāyāsā + asiṃ
māyaṃ	mā + ayaṃ
māyaṃ	me + ayaṃ
kathāvatthupāḷiyampidhammacakkaṃ	kathāvatthu + pāḷiyaṃ + api + dhammacakkaṃ
netaṃ	na + etaṃ
anagārūpanissayoti	anagārūpanissayo + iti
sāyaṃ	sā + ayaṃ
payātumicchasi	payātuṃ + icchasi
mahārājassahaṃ	mahārājassa + ahaṃ
desessanti	desessaṃ + iti
khemātissā	khemā + iti + assā
yathāyampadīpo	yathā + ayaṃ + padīpo
vuṭṭhahissanti	vuṭṭhahissaṃ + iti
tayassu	taya + ssu
abhipatthayanti	abhipatthayaṃ + iti
kappanti	kappaṃ + iti
akālodāni	akālo + idāni
aṅganteva	aṅgaṃ + iti + eva
aṅganteva	aṅgaṃ + eva
ajānamevaṃ	ajānaṃ + evaṃ
ajjuposatho	ajja + uposatho
ajjeva	ajja + eva
ajjhattañca	ajjhattaṃ + ca
aññatreva	aññatra + eva
aññathāsmīti	aññathā + asmi + iti
aññabhāgiyañceva	añña + bhāgiyaṃ + ce + eva
aññamaññassa	aññaṃ + aññassa
aññamaññaṃ	aññaṃ + aññaṃ
aññasseva	aññassa + iva
aññāṇatthampi	aññāṇa + atthaṃ + api
aññāva	aññā + eva
aññenaññaṃ	aññena + aññaṃ
aññenapi	aññena + api
aññenāññaṃ	aññena + aññaṃ
aññeva	aññe + eva
aṭṭhānametaṃ	aṭṭhānaṃ + etaṃ
aṭṭhimāni	aṭṭha + imāni
aṭṭhime	aṭṭha + ime
aṭṭhete	aṭṭha + ete
aṇumattampi	aṇumattaṃ + api
atippageva	ati + pago + eva
atippagova	ati + pago + eva
attahitaparahitaubhayahitasabbalokahitameva	attahita + parahita + ubhayahita + sabbalokahitaṃ + eva
attānaṃyeva	attānaṃ + eva
atthaññaṃ	atthi + aññaṃ
atthañño	atthi + añño
atthamattano	atthaṃ + attano
atthassāyaṃ	atthassa + ayaṃ
atthāvuso	atthi + āvuso
atthekaccāni	atthi + ekaccāni
atthekacco	atthi + ekacco
attheva	atthi + eva
athañño	atha + añño
athassa	atha + assa
athavāpi	atha + vā + api
athāguṃ	atha + āguṃ
athāpara	atha + apara
athāparaṃ	atha + aparaṃ
athāparesaṃ	atha + aparesaṃ
athāpi	atha + api
athāyaṃ	atha + ayaṃ
athāhaṃ	atha + ahaṃ
athekadivasaṃ	atha + eka + divasaṃ
athettha	atha + ettha
athopi	atho + api
adukkhamasukhantipi	adukkhaṃ + asukhaṃ + iti + api
addhamidaṃ	addhaṃ + idaṃ
adhiccamidaṃ	adhiccaṃ + idaṃ
anamataggoyaṃ	anamataggo + ayaṃ
analañca	na + alaṃ + ca
anekapariyāyenāvuso	anekapariyāyena + āvuso
antarāva	antarā + eva
antimoyaṃ	antimo + ayaṃ
antogadhāvāssa	antogadhā + eva + assa
antoyeva	anto + eva
aparāpi	aparā + api
apāvuso	api + āvuso
apica	api + ca
apicettha	api + ca + ettha
apissu	api + ssu
apissudaṃ	api + sudaṃ
apissumaṃ	api + ssu + maṃ
apihaṃ	api + ahaṃ
appañhi	appaṃ + hi
appampi	appaṃ + api
appasmeke	appasmā + eke
appahitepi	na + pahite + api
appahitepi	appahite + api
appekadā	api + ekadā
appeke	api + eke
appeva	api + eva
appevanāma	api + eva + nāma
abhikkamosānaṃ	abhikkamo + esānaṃ
abhijānāmahaṃ	abhijānāmi + ahaṃ
abhibhosmi	abhibhū + asmi
amūlakañceva	amūlakaṃ + ce + eva
amhākañceso	amhākaṃ + ca + eso
amhākañcevāyaṃ	amhākaṃ + ca + eva + ayaṃ
amhākampi	amhākaṃ + api
amhākampetaṃ	amhākaṃ + api + etaṃ
ayañca	ayaṃ + ca
ayañcettha	ayaṃ + ca + ettha
ayañceva	ayaṃ + ca + eva
ayañhi	ayaṃ + hi
ayamattho	ayaṃ + attho
ayamanudhamma	ayaṃ + anudhamma
ayamantarākathā	ayaṃ + antarākathā
ayamantimā	ayaṃ + antimā
ayamassa	ayaṃ + assa
ayamahamasmīti	ayaṃ + ahaṃ + asmi + iti
ayamāyasmā	ayaṃ + āyasmā
ayamāhāro	ayaṃ + āhāro
ayamuddeso	ayaṃ + uddeso
ayamekānupassanā	ayaṃ + eka + anupassanā
ayameko	ayaṃ + eko
ayamettha	ayaṃ + ettha
ayameva	ayaṃ + eva
ayamevettha	ayaṃ + eva + ettha
ayampi	ayaṃ + api
ayaṃsa	ayaṃ + assa
arahantamhā	arahantā + amhā
ariyañcaṭṭhaṅgikaṃ	ariyaṃ + ca + aṭṭhaṅgikaṃ
alañca	alaṃ + ca
alasvassa	alaso + assa
asasmi	asa + asmi
asecanakamojavaṃ	asecanakaṃ + ojavaṃ
asmiñca	asmiṃ + ca
asmīti	asmi + iti
avañjhānitvevāhaṃ	avañjhāni + tu + eva + ahaṃ
avijjampāhaṃ	avijjaṃ + api + ahaṃ
ahañca	ahaṃ + ca
ahañce	ahaṃ + ce
ahañceva	ahaṃ + ce + eva
ahañceva	ahaṃ + ca + eva
ahaññeveko	ahaṃ + eva + eko
ahañhi	ahaṃ + hi
ahanti	ahaṃ + iti
ahamaññatra	ahaṃ + aññatra
ahamasmi	ahaṃ + asmi
ahameva	ahaṃ + eva
ahampāyasmante	ahaṃ + api + āyasmante
ahampi	ahaṃ + api
ahamhi	ahaṃ + hi
āgatamha	āgata + amha
āgatosi	āgato + asi
āditova	ādito + eva
ādimeva	ādiṃ + eva
āpannomhi	āpanno + amhi
āyasmāpi	āyasmā + api
āyāmānanda	āyāma + ānanda
āyāmāvuso	āyāma + āvuso
iccanena	iti + anena
iccādi	iti + ādi
iccāyasmā	iti + āyasmā
iccāsi	iti + āsi
icceke	iti + eke
iccetaṃ	iti + etaṃ
iccete	iti + ete
icceva	iti + eva
iccevamādi	iti + evaṃ + ādi
iccevaṃ	iti + evaṃ
icchāmahaṃ	icchāmi + ahaṃ
icchāyasantyā	icchāya + asantiyā
iñjitametaṃ	iñjitaṃ + etaṃ
iticiti	iti + ca + iti
itipi	iti + api
itissa	iti + assa
itissame	iti + assa + ime
itissime	iti + assa + ime
itissu	iti + ssu
itihanti	iti + ahaṃ + iti
itihetaṃ	iti + hi + etaṃ
itthasmīti	ittha + asmi + iti
ittheke	ittha + eke
itthetaṃ	ittha + etaṃ
itthetepi	ittha + ete + api
idañca	idaṃ + ca
idañcidañca	idaṃ + ca + idaṃ + ca
idañhi	idaṃ + hi
idamassa	idaṃ + assa
idamavoca	idaṃ + avoca
idamavocāyasmā	idaṃ + avoca + āyasmā
idametaṃ	idaṃ + etaṃ
idamettha	idaṃ + ettha
idameva	idaṃ + eva
idampi	idaṃ + api
idānāyasmā	idāni + āyasmā
idānāhaṃ	idāni + ahaṃ
idānihaṃ	idāni + ahaṃ
idāneva	idāni + eva
iddhimantāssunāmime	iddhimantā + ssu + nāma + ime
idhatthi	idha + atthi
idhassa	idha + assa
idhassu	idha + assu
idhānanda	idha + ānanda
idhāvuso	idha + āvuso
idhāhaṃ	idha + ahaṃ
idhūpapanno	idha + upapanno
idheva	idha + eva
idhevāhaṃ	idha + eva + ahaṃ
imañca	imaṃ + ca
imañcāhaṃ	imaṃ + ca + ahaṃ
imañce	imaṃ + ce
imameva	imaṃ + eva
imasmiñca	imasmiṃ + ca
imasmiññeva	imasmiṃ + eva
imasmimpi	imasmiṃ + api
imasmiṃyeva	imasmiṃ + eva
imassuppādā	imassa + uppādā
imassetaṃ	imassa + etaṃ
imaṃyeva	imaṃ + eva
imāhaṃ	imaṃ + ahaṃ
iminānukkamena	iminā + anukkamena
imināpetaṃ	iminā + api + etaṃ
imināsmīti	iminā + asmi + iti
imināhaṃ	iminā + ahaṃ
imettamapi	imaṃ + ettaṃ + api
imesampissa	imesaṃ + api + assa
imeva	ime + eva
imehaṃ	ime + ahaṃ
ivoccante	iva + uccante
utūnīdha	utūni + idha
uttariñca	uttariṃ + ca
uttānatthameva	uttāna + atthaṃ + eva
uttānatthamevāti	uttāna + atthaṃ + eva + iti
uttānatthāneva	uttāna + atthā + eva
uttānameva	uttānaṃ + eva
uttānamevāti	uttānaṃ + eva + iti
upamāyapidhekacce	upamāya + api + idha + ekacce
uparinemassa	upari + nemassa
upasaṅkamatāyasmā	upasaṅkamatu + āyasmā
ubhayametaṃ	ubhayaṃ + etaṃ
ubhopi	ubho + api
ubhova	ubho + eva
ekañca	eka + aṃ + ca
ekaññeva	ekaṃ + eva
ekañhi	ekaṃ + hi
ekadivaseneva	eka + divasena + eva
ekamidāhaṃ	ekaṃ + idaṃ + ahaṃ
ekampi	ekaṃ + api
ekarattampi	ekarattaṃ + api
ekaṃyeva	ekaṃ + eva
ekāyeva	ekā + eva
ekenapi	ekena + api
ekenekā	ekena + ekā
ekeneva	ekena + eva
ekoyeva	eko + eva
ekova	eko + eva
etañca	etaṃ + ca
etañhi	etaṃ + hi
etadaggaṃ	etad + aggaṃ
etadahosi	etad + ahosi
etadeva	etad + eva
etamatthaṃ	etaṃ + atthaṃ
etamahaṃ	etaṃ + ahaṃ
etamādīnava	etaṃ + ādīnava
etampi	etaṃ + api
etasseva	etassa + eva
etenupāyena	etena + upāyena
eteneva	etena + eva
eteyeva	ete + eva
ettakopi	ettako + api
ettāvataggaṃ	ettāvatā + aggaṃ
ettāvatāpi	ettāvatā + api
etthantare	ettha + antare
etthāyaṃ	ettha + ayaṃ
etthete	ettha + ete
etthesā	ettha + esā
ettheva	ettha + eva
esānisaṃso	esa + ānisaṃso
esāhaṃ	eso + ahaṃ
esūpamā	esā + upamā
eseva	eso + eva
esevanto	eso + eva + anto
esohamasmi	eso + ahaṃ + asmi
evañca	evaṃ + ca
evañcetaṃ	evaṃ + ce + etaṃ
evañcetaṃ	evaṃ + ca + etaṃ
evañcettha	evaṃ + ca + ettha
evañhi	evaṃ + hi
evantaṃ	evaṃ + taṃ
evantiparivaṭṭaṃ	evaṃ + tiparivaṭṭaṃ
evamaññepi	evaṃ + aññe + api
evamattho	evaṃ + attho
evamayaṃ	evaṃ + ayaṃ
evamassa	evaṃ + assa
evamassu	evaṃ + assu
evamāvuso	evaṃ + āvuso
evamāha	evaṃ + āha
evamāhaṃsu	evaṃ + āhaṃsu
evamidaṃ	evaṃ + idaṃ
evamīdisesu	evaṃ + īdisesu
evametasmā	evaṃ + etasmā
evametassa	evaṃ + etassa
evametaṃ	evaṃ + etaṃ
evametāsaṃ	evaṃ + etāsaṃ
evametissā	evaṃ + etissā
evametesaṃ	evaṃ + etesaṃ
evamettha	evaṃ + ettha
evamesā	evaṃ + esā
evameva	evaṃ + eva
evamevassu	evaṃ + eva + ssu
evamevaṃ	evaṃ + evaṃ
evamevāyaṃ	evaṃ + eva + ayaṃ
evampi	evaṃ + api
evarūpāpi	evarūpā + api
evarūpepi	evarūpe + api
evarūpopi	evarūpo + api
evassa	eva + assa
evaṃsa	evaṃ + assa
evaṃsmīti	evaṃ + asmi + iti
evāyaṃ	eva + ayaṃ
evāyaṃ	evaṃ + ayaṃ
evāhaṃ	evaṃ + ahaṃ
evetaṃ	eva + etaṃ
evesā	eva + esā
ehambho	ehi + ambho
ehāvuso	ehi + āvuso
okamokata	okaṃ + okata
ogāhamuttiṇṇaṃ	ogāhaṃ + uttiṇṇaṃ
otiṇṇomhi	otiṇṇo + amhi
kaccāhaṃ	kacci + ahaṃ
kaccittha	kacci + ettha
kaccittha	kacci + attha
kaccissu	kacci + su
kacchevāmakase	kacche + iva + amakase
kañcideva	kaṃ + ci + eva
katamañcāvuso	katamaṃ + ca + āvuso
katamettāvatā	kataṃ + ettāvatā
kathañca	kathaṃ + ca
kathañcarahi	kathaṃ + carahi
kathañcānanda	kathaṃ + ca + ānanda
kathañcāvuso	kathaṃ + ca + āvuso
kathañhi	kathaṃ + hi
kathamidaṃ	kathaṃ + idaṃ
kathamime	kathaṃ + ime
kathaṃsu	kathaṃ + su
kathāyaṃ	kathaṃ + ayaṃ
kamatthamanubhoti	kaṃ + atthaṃ + anubhoti
kammakiliṭṭhamattano	kamma + kiliṭṭhaṃ + attano
kammavisuddhimattano	kamma + visuddhiṃ + attano
kayirāthenaṃ	kayirātha + enaṃ
karomahaṃ	karomi + ahaṃ
kalyāṇamittassetaṃ	kalyāṇamittassa + etaṃ
kallosi	kalla + asi
kāyanuttha	kāya + nu + ettha
kāyānamantarena	kāyānaṃ + antarena
kālasseva	kālassa + eva
kālepi	kāle + api
kiccamātappaṃ	kiccaṃ + ātappaṃ
kiñca	kiṃ + ca
kiñcarahi	kiṃ + carahi
kiñcāpi	kiṃ + ca + api
kiñcāyaṃ	kiñci + ayaṃ
kiñcetaṃ	kiṃ + ca + etaṃ
kiñhi	kiṃ + hi
kintāhaṃ	kiṃ + iti + ahaṃ
kintāhaṃ	kiṃ + te + ahaṃ
kinti	kiṃ + iti
kinnu	kiṃ + nu
kinnumāva	kiṃ + nu + imā + eva
kimaññatra	kiṃ + aññatra
kimassa	kiṃ + assa
kimassāhaṃ	kiṃ + assa + ahaṃ
kimahaṃ	kiṃ + ahaṃ
kimāha	kiṃ + āha
kimidaṃ	kiṃ + idaṃ
kimetaṃ	kiṃ + etaṃ
kimevidaṃ	kiṃ + eva + idaṃ
kirāyasmā	kira + āyasmā
kissassu	kissa + ssu
kiṃninnaṃ	kiṃ + ninnaṃ
kiṃpabbhāraṃ	kiṃ + pabbhāraṃ
kiṃpoṇaṃ	kiṃ + poṇaṃ
kiṃsūdha	kiṃ + su + idha
kutettha	kuto + ettha
kudāssu	kudā + ssu
kuddhabhāvamassa	kuddha + bhāva + assa
kecideva	keci + eva
kecime	keci + ime
kenassu	kena + ssu
kenassubbhāhato	kena + ssu + abbhāhato
kenīdha	kena + idha
kenesa	kena + esa
kesaggamattampi	kesa + agga + mattaṃ + api
kesūdha	ka + idha
kocañño	koci + añño
kocideso	koci + deso
kodha	ko + idha
konāmo	ko + nāmo
kosi	ko + asi
kyassa	ke + assa
kyāhaṃ	kiṃ + ahaṃ
kvāssa	kva + assa
kvettha	ko + ettha
khamāmahaṃ	khamāmi + ahaṃ
khārivividhamādāya	khārivividhaṃ + ādāya
khippameva	khippaṃ + eva
khippaṃyeva	khippaṃ + eva
khome	kho + ime
khomhi	kho + amhi
khosi	kho + asi
khosmi	kho + asmi
khohaṃ	kho + ahaṃ
khvassa	kho + assa
khvāyaṃ	kho + ayaṃ
khvāssa	kho + assa
khvāvuso	kho + āvuso
khvāhaṃ	kho + ahaṃ
khvesa	kho + esa
gacchāvuso	gaccha + āvuso
gantumicchasi	gantuṃ + icchasi
gāthamāha	gāthaṃ + āha
gāthācimā	gāthā + ca + imā
ghāsamacchādanaṃ	ghāsaṃ + acchādanaṃ
caggimāsīno	ca + aggiṃ + āsīno
caññe	ca + aññe
cattārimāni	cattāri + imāni
cattārome	cattāro + ime
catthāya	ca + atthāya
catthi	ca + atthi
canekāyatanappavutto	ca + aneka + āyatana + pavutto
cantalikkhasmiṃ	ca + antalikkhasmiṃ
camhi	ca + amhi
carapire	cara + api + re
carahāvuso	carahi + āvuso
cassa	ca + assa
cassa	ce + assa
cassaṃ	ca + assaṃ
cassā	ca + assā
cassu	ca + assu
cāpanataṃ	ca + apanataṃ
cāpanato	ca + apanato
cāpi	ca + api
cāpime	ca + api + ime
cābhinataṃ	ca + abhinataṃ
cābhinato	ca + abhinato
cāyasmatā	ca + āyasmatā
cāyasmā	ca + āyasmā
cāyaṃ	ca + ayaṃ
cāsiṃ	ca + āsiṃ
cāvuso	ca + āvuso
cāha	ca + āha
cāhaṃ	ca + ahaṃ
cāhaṃ	ce + ahaṃ
cāhu	ca + ahu
cāhu	ca + āhu
citiceva	ca + iti + ca + eva
cittamassa	citta + assa
cittamidaṃ	citta + idaṃ
cidaṃ	ca + idaṃ
cimaṃ	ca + imaṃ
cirasseva	cirassa + eva
cuttari	ca + uttari
cudakā	ca + udakā
cūbhayaṃ	ca + ubhaya + aṃ
ceke	ca + eke
cetanāhaṃ	cetanā + ahaṃ
cetarahi	ca + etarahi
cetaṃ	ca + etaṃ
cetaṃ	ce + etaṃ
cetā	ca + etā
cetā	ca + esā
cete	ca + ete
cettha	ca + ettha
cenaṃ	ca + enaṃ
cepi	ce + api
cesa	ce + esa
cesa	ca + esa
ceso	ca + eso
ceva	ce + eva
ceva	ca + eva
cevassa	ca + eva + assa
cevetassa	ce + eva + etassa
cevettha	ca + eva + ettha
corosi	coro + asi
chaccābhiṭhānāni	cha + ca + abhiṭhānāni
channetaṃ	channaṃ + etaṃ
chayimā	cha + imā
chayimāni	cha + imāni
chayime	cha + ime
jarādhammomhi	jarā + dhammo + amhi
jātameva	jātaṃ + eva
jātosmi	jāto + asmi
jānāmahaṃ	jānāmi + ahaṃ
jīvitamattano	jīvitaṃ + attano
jīvitamuttamaṃ	jīvitaṃ + uttamaṃ
jhānalābhīsi	jhāna + lābhī + asi
jhāyinosmā	jhāyino + asmā
ṭhānañhi	ṭhānaṃ + hi
ṭhitomhi	ṭhito + amhi
tañca	taṃ + ca
tañcassa	taṃ + ca + assa
tañcāyatanaṃ	taṃ + ca + āyatanaṃ
tañcāyaṃ	taṃ + ca + ayaṃ
tañcāhaṃ	taṃ + ca + ahaṃ
tañce	taṃ + ce
tañceva	taṃ + ca + eva
taññeva	taṃ + eva
taññevettha	taṃ + eva + ettha
tañhi	taṃ + hi
tañhissa	taṃ + hi + assa
taṇhamabbuyha	taṇhaṃ + abbuyha
tatiyampi	tatiyaṃ + api
tatohaṃ	tato + ahaṃ
tatthaddasaṃ	tattha + addasaṃ
tatthāyasmante	tattha + āyasmante
tatthāyaṃ	tattha + ayaṃ
tatthāhaṃ	tattha + ahaṃ
tatthetaṃ	tattha + etaṃ
tattheva	tattha + eva
tatthevantaradhāyi	tattha + eva + antaradhāyi
tatthevantaradhāyīti	tattha + eva + antaradhāyi + iti
tatrapime	tatra + api + ime
tatrassa	tatra + assa
tatrāpāsiṃ	tatra + api + āsiṃ
tatrāpāhaṃ	tatra + api + ahaṃ
tatrāpi	tatra + api
tatrāyaṃ	tatra + ayaṃ
tatrāssa	tatra + assa
tatrāssu	tatra + ssu
tatrāvuso	tatra + āvuso
tatridamekaṃ	tatra + idaṃ + ekaṃ
tatridaṃ	tatra + idaṃ
tatrime	tatra + ime
tatreko	tatra + eko
tatreva	tatra + eva
tatvassa	tato + assa
tathariva	tathā + eva
tathāpi	tathā + api
tathāyaṃ	tathā + ayaṃ
tathāhaṃ	tathā + ahaṃ
tathūpamāhaṃ	tathā + upama + ahaṃ
tatheva	tathā + eva
tatheva	tatha + eva
tadajjahaṃ	tad + ajja + ahaṃ
tadadhimutto	tad + adhimutto
tadanuttaraṃ	tad + anuttaraṃ
tadanudhammañca	tad + anudhammaṃ + ca
tadapi	tad + api
tadamariyānaṃ	tad + idaṃ + ariyānaṃ
tadaminā	tad + iminā
tadamināpetaṃ	tad + aminā + api + etaṃ
tadariyā	tad + ariyā
tadassa	tad + assa
tadahuposathe	tad + aha + uposathe
tadāpi	tadā + api
tadiṅgha	tad + iṅgha
tadidaṃ	tad + idaṃ
tadeva	tad + eva
tadevassa	tad + eva + assa
tadevāhaṃ	tad + eva + ahaṃ
tadevekaccesu	tad + eva + ekaccesu
tapantamādiccamivantalikkhe	tapantaṃ + ādiccaṃ + iva + antalikkhe
tamaññe	taṃ + aññe
tamañño	taṃ + añño
tamattha	taṃ + attha
tamatthaṃ	taṃ + atthaṃ
tamahaṃ	taṃ + ahaṃ
tamāhu	taṃ + āhu
tamenaṃ	taṃ + enaṃ
tameva	taṃ + eva
tamevassa	taṃ + eva + assa
tamevūpekkhaṃ	taṃ + eva + upekkhā + aṃ
tampi	taṃ + api
tampissa	taṃ + api + assa
tammayaṃ	taṃ + mayaṃ
tamhuddhaṭe	tamhi + uddhaṭe
tayāmhi	tayā + amhi
tayome	tayo + ime
tarathetaṃ	taratha + etaṃ
tasmiṃyeva	tasmiṃ + eva
tassattho	tassa + attho
tassapi	tassa + api
tassassu	tassa + assu
tassāyeva	tassā + eva
tassāhaṃ	tassa + ahaṃ
tassimāni	tassa + imāni
tassime	tassa + ime
tassimesu	tassa + imesu
tassīdha	tassa + idha
tassuttarato	tassa + uttarato
tassuddānaṃ	tassa + uddānaṃ
tassetaṃ	tassa + etaṃ
tassesā	tassa + esā
tasseva	tassa + eva
tassevanti	tassa + evaṃ + iti
tassevaṃ	tassa + evaṃ
taveva	tava + eva
taṃyevettha	taṃ + eva + ettha
tādisameva	tādisa + eva
tādisaṃyeva	tādisaṃ + eva
tādisovassa	tādiso + eva + assa
tānassu	tāni + assu
tānāssu	tāni + assu
tāsañca	tāsaṃ + ca
tāsaṃyeva	tāsaṃ + eva
tāsāhaṃ	tāsu + ahaṃ
tāvatakeneva	tāvatakena + eva
tāvatakvassa	tāvatako + assa
tāvadevassā	tāva + eva + assā
tiādi	iti + ādi
tiādimāha	iti + ādiṃ + āha
tiṭṭhatetaṃ	tiṭṭhatu + etaṃ
tiṭṭhatesā	tiṭṭhatu + esā
tiriyañca	tiriyaṃ + ca
tīṇaṅgāni	tīṇi + aṅgāni
tīṇimāni	tīṇi + imāni
tīramevānudhāvati	tīraṃ + eva + anudhāvati
tumhākampi	tumhākaṃ + api
tumhepi	tumhe + api
tuyhañhi	tuyhaṃ + hi
tuyhameva	tuyhaṃ + eva
tuyhampi	tuyhaṃ + api
tuyhiminā	tuyhaṃ + iminā
tuvañhi	tuvaṃ + hi
tuvaṃtuvaṃ	tuvaṃ + tuvaṃ
tenañjaliṃ	tena + añjaliṃ
tenapi	tena + api
tenahāyasmā	tena + hi + āyasmā
tenahāvuso	tena + hi + āvuso
tenahi	tena + hi
tenāyaṃ	tena + ayaṃ
tenāha	tena + āha
tenāhaṃ	tena + ahaṃ
tenāhu	tena + āhu
teneva	tena + eva
tenevantaravassena	tena + eva + antaravassena
tenevāha	tena + eva + āha
tepare	te + pare
tesañca	tesaṃ + ca
tesaññeva	tesaṃ + eva
tesantakaro	tesaṃ + antakaro
tesampi	tesaṃ + api
tesaṃyeva	tesaṃ + eva
tesāhaṃ	tesaṃ + ahaṃ
teva	te + eva
tvañca	tvaṃ + ca
tvaññeva	tvaṃ + eva
tvamasi	tvaṃ + asi
tvampi	tvaṃ + api
tvaṃyeva	tvaṃ + eva
tveva	tu + eva
tvevāhaṃ	tu + eva + ahaṃ
thenosi	theno + asi
dantamādhāya	dantaṃ + ādhāya
dantebhidantamādhāya	dantebhi + dantaṃ + ādhāya
dasayimāni	dasa + imāni
dasayime	dasa + ime
dasahaṅgehi	dasahi + aṅgehi
dassanakāmamhā	dassana + kāma + amhā
daḷhamenaṃ	daḷhaṃ + enaṃ
dānāyaṃ	dāni + ayaṃ
dānāhaṃ	dāni + ahaṃ
dānime	dāni + ime
dānisi	dāni + asi
diṭṭhevadhamme	diṭṭhe + eva + dhamme
diṭṭhosi	diṭṭho + asi
dibbenādhipateyyena	dibbena + ādhipateyyena
disvāva	disvā + eva
dīghamāpajjate	dīghaṃ + āpajjate
dīgharattamidaṃ	dīgha + rattaṃ + idaṃ
dukkhanti	dukkhaṃ + iti
dukkhantipi	dukkhaṃ + iti + api
dukkhamappiyaṃ	dukkhaṃ + appiyaṃ
dukkhamidaṃ	dukkhaṃ + idaṃ
dukkhosamānasaṃvāso	dukkho + samāna + saṃvāso
dutiyampi	dutiyaṃ + api
dūratopi	dūrato + api
dūratova	dūrato + eva
desitādiccabandhunā	desitaṃ + ādiccabandhunā
devarajjamakārayiṃ	devarajjaṃ + akārayiṃ
devānumodanti	devā + anumodanti
devāpi	devā + api
dvāhaṃ	dvi + ahaṃ
dvemā	dve + imā
dvemāni	dve + imāni
dveme	dve + ime
dveyeva	dve + eva
dveva	dve + eva
dhammamuttamaṃ	dhammaṃ + uttamaṃ
dhammameva	dhamma + eva
dhammesa	dhamme + esa
nacirasseva	na + cirassa + eva
najja	nu + ajja
natthaññaṃ	na + atthi + aññaṃ
natthañño	na + atthi + añño
natthidāni	natthi + idāni
nanāyaṃ	nanu + ayaṃ
napi	na + api
nayenettha	nayena + ettha
nassu	na + ssu
navayime	nava + ime
nāṇupi	na + aṇu + api
nāmassu	nāma + su
nāmāyaṃ	nāma + ayaṃ
nāmāhaṃ	nāma + ahaṃ
nāmete	nāma + ete
nāmeso	nāma + eso
nāmhi	na + amhi
nāyamāyasmā	na + ayaṃ + āyasmā
nāyaṃ	na + ayaṃ
nāyaṃ	nu + ayaṃ
nāssa	na + assa
nāssudha	na + ssu + idha
nāssudha	na + assudha
nibbānamattano	nibbānaṃ + attano
nisinnomhi	nisinno + amhi
nuttha	nu + ettha
numāni	nu + imāni
nuhaṃ	nu + ahaṃ
nūnāhaṃ	nūna + ahaṃ
nekattamupapajjati	na + ekattaṃ + upapajjati
nevattato	na + eva + attato
nevattasañcetanā	na + eva + atta + sañcetanā
nocidha	no + ca + idha
notevettha	no + iti + eva + ettha
nvayaṃ	nu + ayaṃ
pakkamatāyasmā	pakkamatu + āyasmā
pageva	pago + eva
paccattaññeva	paccattaṃ + eva
pacchatopissa	pacchato + api + assa
pacchāsaṃ	pacchā + esaṃ
pacchāssa	pacchā + assa
pañcamettha	pañcamo + ettha
pañcasupādānakkhandhesu	pañcasu + upādānakkhandhesu
pañcimā	pañca + imā
pañcimāni	pañca + imāni
pañcime	pañca + ime
pañcete	pañca + ete
paññāṇamaggino	paññāṇaṃ + aggino
paññāṇamitthiyā	paññāṇaṃ + itthiyā
paṭikacceva	paṭikacca + eva
paṭikkamosānaṃ	paṭikkamo + esānaṃ
paṭisanthāravutyassa	paṭisanthāra + vutti + assa
paṭhamaññeva	paṭhamaṃ + eva
paṇītametaṃ	paṇītaṃ + etaṃ
pattakāyena	patta + kāyena
pattacīvaramādāya	pattaṃ + cīvaraṃ + ādāya
panaññampi	pana + aññaṃ + api
panaññānipi	pana + aññāni + api
panassa	pana + assa
panāniccaṃ	pana + aniccaṃ
panāyamāyasmā	pana + ayaṃ + āyasmā
panāyasmato	pan + āyasmato
panāyasmantaṃ	pana + āyasmantaṃ
panāyasmanto	pana + āyasmanto
panāyasmā	pana + āyasmā
panāyaṃ	pana + ayaṃ
panāssu	pana + assu
panāvuso	pana + āvuso
panāhaṃ	pana + ahaṃ
panidaṃ	pana + idaṃ
panimassa	pana + imassa
panimaṃ	pana + imaṃ
panimāni	pana + imāni
panimehi	pana + imehi
paneke	pana + eke
panetaṃ	pana + etaṃ
panete	pana + ete
panettha	pana + ettha
panesā	pana + esā
paneso	pana + eso
paneva	pana + eva
pabbajitomhi	pabbajito + amhi
pabbatamuddhaniṭṭhito	pabbatamuddhani + ṭhito
pamādattha	pamāda + attha
pamutyatthi	pamutti + atthi
parañca	paraṃ + ca
paramajjadhammesu	parama + ajja + dhammesu
paramattakāmo	paraṃ + attakāmo
parisuddhetthāyasmanto	parisuddhā + ettha + āyasmanto
passāmahaṃ	passāmi + ahaṃ
paviṭṭhamhā	paviṭṭha + amhā
pātova	pāto + eva
pāpañce	pāpaṃ + ce
pāpamāgamā	pāpaṃ + āgamā
pāyaṃ	api + ayaṃ
pāsādamāruyha	pāsādaṃ + āruyha
pāḷinayeneva	pāḷi + nayena + eva
piyataramattanā	piyataraṃ + attanā
pucchāvuso	puccha + āvuso
puṭṭhohaṃ	puṭṭho + ahaṃ
punadeva	puna + eva
punapi	puna + api
punareva	puna + eva
pubbeva	pubbe + eva
puratopissa	purato + api + assa
purimanayeneva	purima + nayena + eva
pūjitamettāvatā	pūjitaṃ + ettāvatā
phullamavītagandhaṃ	phullaṃ + avītagandhaṃ
balavamhi	balavā + amhi
bahudeva	bahu + eva
bahuneke	bahunā + eke
bālosi	bālo + asi
buddhagāthābhigītomhi	buddha + gāthā + abhigīto + amhi
buddhavacanānussaraṇavasenetaṃ	buddhavacana + anussaraṇa + vasena + etaṃ
buddhosmi	buddho + asmi
byādhidhammomhi	byādhi + dhammo + amhi
brāhmaṇamhā	brāhmaṇā + amhā
bhayamantarato	bhayaṃ + antarato
bhavamatthu	bhavaṃ + atthu
bhavissanti	bhavissaṃ + iti
bhavobhirādhito	bhavo + abhirādhito
bhāsitampetaṃ	bhāsitaṃ + api + etaṃ
bhūtapubbāhaṃ	bhūtapubbaṃ + ahaṃ
bhūtamidaṃ	bhūtaṃ + idaṃ
maggakkhāyīhaṃ	magga + akkhāyī + ahaṃ
maññitametaṃ	maññitaṃ + etaṃ
maññevettha	maṃ + eva + ettha
matthi	me + atthi
manāpeneva	manāpena + eva
mantaṃ	maṃ + taṃ
mamaccaye	mama + accaya + e
mamañca	mamaṃ + ca
mamaññeva	mamaṃ + eva
mamanti	mamaṃ + iti
mamapi	mama + api
mamassa	mama + assa
mameva	mama + eva
mamevārabbha	maṃ + eva + ārabbha
mamevettha	maṃ + eva + ettha
mayañhi	mayaṃ + hi
mayamettha	mayaṃ + ettha
mayampi	mayaṃ + api
mayampetaṃ	mayaṃ + api + etaṃ
mayāpi	mayā + api
mayhaṃpatthi	mayhaṃ + api + atthi
mayhevekassa	mayhaṃ + eva + ekassa
maraṇadhammomhi	maraṇa + dhamma + amhi
mahamattasambhavaṃ	ahaṃ + attasambhavaṃ
māyasmanto	mā + āyasmanto
māyasmā	mā + āyasmā
midaṃ	idaṃ
muṇḍāsi	muṇḍā + asi
muttosi	mutto + asi
muhuttampi	muhuttaṃ + api
mūḷhosi	mūḷho + asi
meso	me + eso
moghamaññanti	moghaṃ + aññaṃ + iti
moghamaññaṃ	moghaṃ + aññaṃ
modahaṃ	modi + ahaṃ
yaggheyye	yagghe + ayye
yañca	yaṃ + ca
yatassa	yato + assa
yatthapi	yattha + api
yatthassa	yattha + assa
yatthākicchena	yattha + akicchena
yatthāhaṃ	yattha + ahaṃ
yatthimā	yattha + imā
yatthetaṃ	yattha + etaṃ
yattheva	yattha + eva
yatvādhikaraṇamenaṃ	yato + adhikaraṇaṃ + enaṃ
yathayidaṃ	yathā + idaṃ
yathājja	yathā + ajja
yathāttanā	yathā + attanā
yathāpi	yathā + api
yathāyaṃ	yathā + ayaṃ
yathāssa	yathā + assa
yathāhaṃ	yathā + ahaṃ
yatheva	yathā + eva
yathevaṃ	yathā + evaṃ
yadaggi	yadā + aggi
yadatthi	yad + atthi
yadapi	yad + api
yadāpi	yadā + api
yadāyasmantānaṃ	yadi + āyasmantānaṃ
yadāyaṃ	yadā + ayaṃ
yadāhaṃ	yadā + ahaṃ
yadidaṃ	yad + idaṃ
yadipime	yadi + api + ime
yadetaṃ	yad + etaṃ
yadettha	yad + ettha
yadeva	yad + eva
yantaṃ	yaṃ + taṃ
yamāhu	yaṃ + āhu
yametamatthaṃ	yaṃ + etaṃ + atthaṃ
yametaṃ	yaṃ + etaṃ
yassa	yo + assa
yassadāni	yassa + dāni
yassassu	yassa + assu
yassāhaṃ	yassa + ahaṃ
yassiñjitaṃ	yassa + iñjitaṃ
yasseva	yassa + eva
yaṃpaccayāssa	yaṃ + paccayā + assa
yānimāni	yāni + imāni
yānīdha	yāni + idha
yāyaṃ	yā + ayaṃ
yāvakīvañca	yāva + kīvaṃ + ca
yāvañcidaṃ	yāva + ca + idaṃ
yāvatakvassa	yāvatā + ko + assa
yāvatatiyañca	yāva + tatiyaṃ + ca
yāvatatiyañce	yāva + tatiyaṃ + ce
yāvatājagatogati	yāvatā + jagato + gati
yāvasubhāsitamidaṃ	yāva + subhāsitaṃ + idaṃ
yāvassu	yāva + ssu
yāvāhaṃ	yāva + ahaṃ
yāhayaṃ	yāhi + ayaṃ
yāhu	yo + ahu
yuñjantāyasmanto	yuñjantu + āyasmanto
yenaññataro	yena + aññataro
yenattho	yena + attho
yenassa	yena + assa
yenāyasmā	yena + āyasmā
yenāhaṃ	yena + ahaṃ
yeneva	yena + eva
yesañca	yesaṃ + ca
yesīdha	yesu + idha
yotivākyaṃ	yo + ativākyaṃ
yodha	yo + idha
yopi	yo + api
yopissa	yo + api + assa
yomaṃ	yo + imaṃ
yohaṃ	yo + ahaṃ
yvāyaṃ	yo + ayaṃ
yvāssa	yo + assa
rakkhassetaṃ	rakkhassu + etaṃ
ramāmahaṃ	ramāmi + ahaṃ
rājāhaṃ	rāja + ahaṃ
riva	iva
riva	eva
laṅghetumicchasi	laṅghetuṃ + icchasi
labhantatthe	labhanti + atthe
labheyyāhaṃ	labbheyyaṃ + ahaṃ
labheyyāhaṃ	labheyyaṃ + ahaṃ
lābhīmhi	lābhī + amhi
lokamimaṃ	lokaṃ + imaṃ
lopamāpajjate	lopaṃ + āpajjate
sakiṃdeva	sakiṃ + eva
saggakāyamagamaṃ	saggakāyaṃ + agamaṃ
saṅkhāresūpasantesu	saṅkhāresu + upasantesu
sacajja	sace + ajja
sacāyaṃ	sace + ayaṃ
sacāhaṃ	sace + ahaṃ
sacepi	sace + api
saññīmeva	saññī + eva
saṭhāssunāmime	saṭhā + ssu + nāma + ime
satasmīti	sat + asmi + iti
satasmīti	sata + asmi + iti
satova	sato + eva
sattantarā	satta + antarā
sattahaṅgehi	sattahi + aṅgehi
sattimā	satta + imā
sattime	satta + ime
satyassa	sati + assa
sadisohamasmi	sadiso + ahaṃ + asmi
sadisohamasmīti	sadiso + ahaṃ + asmi + iti
saddhimattho	saddhiṃ + attho
saddhīdha	saddhā + idha
santametaṃ	santaṃ + etaṃ
santaṃyeva	santaṃ + eva
santāvuso	santi + āvuso
santimuttamaṃ	santiṃ + uttamaṃ
sandhāyāha	sandhāya + āha
sandhāyetaṃ	sandhāya + etaṃ
sabbamaññaṃ	sabbaṃ + aññaṃ
sabbamidaṃ	sabbam + idaṃ
sabbametaṃ	sabbaṃ + etaṃ
sabbāneva	sabbāni + eva
sabbete	sabbe + ete
sabbesampissa	sabbesaṃ + api + assa
sabbeva	sabbe + eva
sabbeheva	sabbehi + eva
sabbhireva	sabbhi + eva
samaṇamhā	samaṇā + amhā
samaṇīdha	samaṇaṃ + idha
samatthi	sama + atthi
sametāyasmantānaṃ	sametu + āyasmantānaṃ
sametāyasmā	sametu + āyasmā
sampadamidaṃ	sampadaṃ + idaṃ
sampannatthūdha	sampanna + atthu + idha
samphalaṃ	saṃ + phalaṃ
sambādhapaṭipannosmi	sambādha + paṭipanno + asmi
sayameva	sayaṃ + eva
sayānomhi	sayāno + amhi
sallamattano	sallaṃ + attano
sahāpi	saha + api
sahāvassa	saha + eva + assa
saṃvāsamanvāya	saṃvāsaṃ + anvāya
saṃvijjantassa	saṃvijjanti + assa
sādhayye	sādhu + ayye
sādhāvuso	sādhu + āvuso
sāmampi	sāmaṃ + api
sāyeva	sā + eva
sīdha	su + idha
sīlesvevassa	sīlesu + eva + assa
sīhaṃvekacaraṃ	sīhaṃ + iva + ekacaraṃ
sukhantipi	sukhaṃ + iti + api
sucirasseva	sucirassa + eva
sudaṃ	su + idaṃ
sudāhaṃ	sudaṃ + ahaṃ
seṭṭhamupanamaṃ	seṭṭhaṃ + upanamaṃ
seyyathāpi	se + yathā + api
seyyathidaṃ	se + yathā + idaṃ
seyyathīdaṃ	se + yathā + idaṃ
seyyohamasmi	seyyo + ahaṃ + asmi
seyyohamasmīti	seyyo + ahaṃ + asmi + iti
sesapadadvayepi	sesa + pada + dvaye + api
sesapadesupi	sesapadesu + api
sesamettha	sesaṃ + ettha
sesavāresupi	sesavāresu + api
sesesupi	sesesu + api
sotthimattānaṃ	sotthiṃ + attānaṃ
somaṃ	so + imaṃ
soyanti	so + ayaṃ + iti
svājja	so + ajja
svāyamattho	so + ayaṃ + attho
sveva	so + eva
vatamhi	vata + amhi
vatayaṃ	vata + ayaṃ
vatassāhaṃ	vata + assaṃ + ahaṃ
vatāyasmantaṃyeva	vata + āyasmantaṃ + eva
vatāyaṃ	vata + ayaṃ
vatāhaṃ	vata + ahaṃ
vatidaṃ	vata + idaṃ
vatime	vata + ime
vadāmahaṃ	vadāmi + ahaṃ
vayañcassānupassati	vayaṃ + ca + assa + anupassati
vareyyāhe	vareyya + ahe
vasenetaṃ	vasena + etaṃ
vāti	vā + iti
vāpi	vā + api
vāpi	ve + api
vāyaṃ	vā + ayaṃ
vāyaṃ	ve + ayaṃ
vāraññe	vā + araññe
vāsi	ve + asi
vāhametaṃ	vā + ahaṃ + etaṃ
vāhaṃ	vā + ahaṃ
vināyeva	vinā + eva
vippamuttosi	vippamutto + asi
vimuttamattānaṃ	vimuttaṃ + attānaṃ
vimuttomhi	vimutto + amhi
viramathāyasmanto	viramatha + āyasmanto
visuddhamattānaṃ	visuddhaṃ + attānaṃ
vissāsamanvāya	vissāsaṃ + anvāya
vivicceva	vivicca + eva
viharatāyasmā	viharatu + āyasmā
vihārotveva	vihāro + tu + eva
vuccatāvuso	vuccati + āvuso
vuttañhetaṃ	vuttaṃ + hi + etaṃ
vuttatthāneva	vutta + atthā + eva
vuttanayāneva	vuttanayāni + eva
vuttanayeneva	vutta + nayena + eva
vuttamarahatāti	vuttaṃ + arahatā + iti
vuttamidaṃ	vutta + idaṃ
vuttānusāreneva	vutta + anusārena + eva
vuttāhaṃ	vutte + ahaṃ
vuddhihesā	vuddhi + hi + esā
vekacaraṃ	iva + ekacaraṃ
veditabbametaṃ	veditabbaṃ + etaṃ
vocchijjatārammaṇaṃ	vocchijjati + ārammaṇaṃ
haññadatthatthipasaṃsalābhā	hi + añña + attha + atthi + pasaṃsā + lābhā
hatthamevānukantati	hatthaṃ + eva + anukantati
handāhaṃ	handa + ahaṃ
hayaṃ	hi + ayaṃ
halaṃ	hi + alaṃ
hānanda	hi + ānanda
hāyaṃ	hi + ayaṃ
hāvuso	hi + āvuso
hitamattano	hitaṃ + attano
hidaṃ	hi + idaṃ
himavāññe	himavā + āññe
himavāvaññe	himavā + iva + aññe
hissa	hi + assa
hissa	hi + ssa
hīnohamasmi	hīno + ahaṃ + asmi
hīnohamasmīti	hīno + ahaṃ + asmi + iti
hīme	hi + ime
heke	hi + eke
hetaṃ	hi + etaṃ
hete	hi + ete
hettha	hi + ettha
hesā	hi + esā
heva	hi + eva
hevantissa	hi + evaṃ + iti + assa
hevaṃ	hi + evaṃ
hoteva	hoti + eva
santamassa	santaṃ + assa
santi	saṃ + iti
tathārūpāssa	tathārūpā + assa
yadatītampahīnantaṃ	yad + atītaṃ + pahīnaṃ + taṃ
samādhimānantarikaññamāhu	samādhiṃ + ānantarikaṃ + yaṃ + āhu
yadajjhagā	yad + ajjhagā
jīvitamāhu	jīvitaṃ + āhu
appevanāmimassa	api + eva + nāma + imassa
dukkhamanveti	dukkhaṃ + anveti
sukhamanveti	sukhaṃ + anveti
lābhimhi	lābhī + amhi
yathāmedaṃ	yathā + me + idaṃ
tavāhamasmi	tava + ahaṃ + asmi
sakhāhamasmi	sakha + ahaṃ + asmi
sotāvadhānūpanisūpapanne	sotāvadhāna + upanisā + upapanne
asīti	asi + iti
panāyasmante	pana + āyasmante
ajānamevāhaṃ	ajānaṃ + evaṃ + ahaṃ
sopalepapatito	so + upalepa + patito
caṇḍettha	caṇḍā + ettha
avijjāyatveva	avijjāya + iti + eva
avijjāyatveva	avijjāya + tu + eva
ahovatime	aho + vata + ime
brahmunāpesā	brahmunā + api + esā
pariyāyanti	pariyāyaṃ + iti
evamassāyaṃ	evaṃ + assu + ayaṃ
nayimā	na + imā
ujjaletunti	ujjaletuṃ + iti
apāyadukkhavisesabhūtā	apāya + dukkha + visesa + bhūtā
ālayanti	ālayaṃ + iti
panassā	pana + assā
gāmantavihārināpīti	gāmantavihārinā + api + iti
saggūpagenapīti	saggūpagena + api + iti
tathevākāsi	tathā + eva + ākāsi
kaṅkhanti	kaṅkhaṃ + iti
avasesayaññaṭṭhāne	avasesa + yañña + ṭhāne
santaggivessana	santi + aggivessana
maggāmaggadhammassa	magga + amagga + dhammassa
pubbakehesā	pubbakehi + esā
ayanti	ayaṃ + iti
kukkuropi	kukkuro + api
kimidanti	kiṃ + idaṃ + iti
mayamevamhā	mayaṃ + eva + amhā
kosiyātveva	kosiyā + iti + eva
hatthi	hi + atthi
paññāva	paññā + eva
halanti	hi + alaṃ + iti
āsūpasampadā	āsu + upasampadā
āsūpasampadā	āsi + upasampadā
apāpuretaṃ	apāpura + etaṃ
huveyyapāvuso	huveyya + api + āvuso
ṭhitamaṭṭhitoti	ṭhitaṃ + aṭṭhito + iti
metanti	metaṃ + iti
anussāvessatūti	anussāvessati + iti
pabbajitosīti	pabbajito + asi + iti
ajjuposathoti	ajjuposatho + iti
nāmetaṃ	nāma + etaṃ
khippāhaṃ	khippaṃ + ahaṃ
caparāhaṃ	ca + paraṃ + ahaṃ
paccessanti	paccessaṃ + iti
kappanahutehīti	kappanahutehi + iti
kaṅkhāhu	kaṅkhā + ahu
rājāhamasmi	rājā + ahaṃ + asmi
mesā	me + esā
katamettha	katame + ettha
cittassete	cittassa + ete
cayaṃ	ca + ayaṃ
tesāhamasmi	tesaṃ + ahaṃ + asmi
apagatamakkhikaṇḍakaṃ	apagata + makkhika + aṇḍakaṃ
yāvañcidha	yāva + ca + idha
uttaranti	uttaraṃ + iti
ariyāyetaṃ	ariyāya + etaṃ
tesamete	tesaṃ + ete
āyatanamakkhāyati	āyatanaṃ + akkhāyati
tadimināpetaṃ	tad + iminā + api + etaṃ
saratāyasmā	saratu + āyasmā
sādhukameva	sādhukaṃ + eva
ṭhānametaṃ	ṭhānaṃ + etaṃ
āvāsādisattavidhasappāyāsevanakiriyāya	āvāsa + ādi + sattavidha + sappāya + āsevana + kiriyāya
pasaddo	pa + saddo
etesanti	ete + santi
amatamadhigataṃ	amataṃ + adhigataṃ
ayamahamasmi	ayaṃ + ahaṃ + asmi
katthūpapattiṃ	kattha + upapattiṃ
kyassu	ke + assu
vihārimātāpiṃ	vihāriṃ + ātāpiṃ
appekadāhaṃ	api + ekadā + ahaṃ
yāyamhi	yāya + amhi
teme	te + ime
tenahāyasmanto	tena + hi + āyasmanto
pañcahaṅgehi	pañcahi + aṅgehi
yatohaṃ	yato + ahaṃ
sāvakohamasmi	sāvako + ahaṃ + asmi
idhāssu	idha + assu
tamettha	taṃ + ettha
nālamettha	na + alaṃ + ettha
kaccāsi	kacci + asi
tadevettha	tad + eva + ettha
ahamettha	ahaṃ + ettha
yatthassu	yattha + assu
tesamidaṃ	tesaṃ + idaṃ
gacchagumbhādīnampi	gaccha + gumbha + ādīnaṃ + api
idamāsanaṃ	idaṃ + āsanaṃ
sovāhaṃ	so + eva + ahaṃ
saṅkhāti	saṅkhā + iti
savaḍḍhi	sa + vaḍḍhi
teladhārāva	teladhārā + iva
sayuddhattā	sa + yuddha + ttā
yopesa	yo + api + esa
ubhopete	ubho + api + ete
ūsakhaṇḍaṃ 	ūsa + khaṇḍaṃ 
ūsakhaṇḍanti	ūsa + khaṇḍaṃ + iti 
nujju	na + ujju
ṭhānameke	ṭhānaṃ + eke
yadapaṇṇakanti	yad + apaṇṇakaṃ + iti
yadimeti	yadi + ime + iti
caparantiādimāha	ca + paraṃ + iti + ādiṃ + āha
kālānamaccayena	kālānaṃ + accayena
akanti	akaṃ + iti
rāgasaṅgādayo	rāga + saṅga + ādayo
bhūdhātuto	bhū + dhātuto
vattamānattanopada	vattamāna + attanopada
bhittipādussāpanādinā	bhittipāda + ussāpana + ādinā
kālātipattiiccetāsu	kālātipatti + iti + etāsu
akkhacchinnovajhāyati	akkhacchinno + avajhāyati
taddhitākhyāta	taddhita + ākhyāta
padakkhara	pada + akkhara
akkharappabhedānaṃ 	akkhara + pabhedānaṃ 
kādayo	ka + ādayo
akkhānañca	akkhānaṃ + ca
bhikkhunīnamovādo	bhikkhunīnaṃ + ovādo
yevāvasissati	eva + avasissati
gamuiccetassa	gamu + iti + etassa
agarukatvāti	agarukatvā + iti
sītavinodana	sīta + vinodana
bhattapacanādi	bhattapacana + ādi
sammajjanupalepana	sammajjana + upalepana
yadime	yadi + ime
gamissanti	gamissaṃ + iti
pañcālarājānamevālapati	pañcālarājānaṃ + eva + ālapati
panassaṃ	pana + assaṃ
katihākārehi	katihi + ākārehi
parīti	pari + iti
nānaggarasasūpabyañjanoti	nāna + aggarasa + sūpa + byañjano + iti
arahattappattadivaseyevassa	arahattappatta + divase + eva + assa
tāvāti	tāva + iti
ācariyupajjhāyavattādīni	ācariyupajjhāya + vatta + ādīni
iṇapīḷitāti	iṇa + pīḷitā + iti
aparimeyyito	aparimeyye + ito
koādesaṃ	ko + ādesaṃ
ṇādesaṃ	ṇā + desaṃ
lokekanāyako	loke + eka + nāyako
tamasaṅkhātaṃ	tama + saṅkhātaṃ
susamāhitantiādimāha	susamāhitaṃ + iti + ādiṃ + āha
tāvetassa	tāva + etassa
conatāti	ca + onatā + iti
panāyamāhāro	pana + ayaṃ + āhāro
atijighacchapiḷitopi	atijighaccha + piḷito + api
tassadikoti	taṃ + sadiko + iti
gāyantītivā	gāyanti + iti + vā
yassāsetādisī	yassa + āsi + etādisī
ekāhi	ekā + hi
nevitthī	na + eva + itthī
yidhattho	idha + attho
panātiādimāha	pana + iti + ādiṃ + āha
nevasekkhanāsekkho	na + eva + sekkha + na + asekkho
vātiādinā	vā + iti + ādinā
hītiādimāha	hi + iti + ādiṃ + āha
noāsavo	no + āsavo
itoti	ito + iti
metādiso	me + tādiso
metādiso	me + etādiso
nocitto	no + citto
vātiādīsu	vā + iti + ādīsu
nevavipākanavipākadhammadhammaṃ	na + eva + vipāka + na + vipākadhamma + dhammaṃ
noatthiyā	no + atthiyā
nosaññāvimokkhaṃ	no + saññāvimokkhaṃ
kintu	kiṃ + tu
cātiādimāha	cā + iti + ādiṃ + āha
etīti	eti + iti
nocittaṃ	no + cittaṃ
nocittasamuṭṭhāno	no + cittasamuṭṭhāno
sotipi	so + iti + api
mānamadapurisamadādayo	mānamada + purisamada + ādayo
pacchibhājanañca	pacchi + bhājanaṃ + ca
kammārohanaṃ	kammā + ārohanaṃ
aññadeva	aññaṃ + eva
santilakkhaṇaṃ	santi + lakkhaṇaṃ
piṇḍapātāpacāyanatā	piṇḍapāta + apacāyana + tā
tibuddhakhettekadivākaraṃ	ti + buddha + khetta + eka + divākaraṃ
yāssu	yā + ssu
kilesatamasaṅkhātaṃ	kilesa + tama + saṅkhātaṃ
kilesatamasodhanaṃ	kilesatamas + sodhanaṃ
ubhotthamaparājitāti	ubho  + ettha + aparājitā + iti
maddakkhu	m + addakkhu
maddakkhūti	addakkhu + iti
metiādīni	me + iti + ādīni
paupaitievamādikaṃ	pa + upa + iti + eva + ādikaṃ
ṇāpayaiccete	ṇāpaya + iti + ete
amādayo	aṃ + ādayo
rājāmanupāyāsi	rājā + anupāyāsi
atthitveva	atthi + iti + eva
punabbhavasaṅkhāraṇakaṃ	punabbhava + saṅkhāraṇakaṃ
maṃbravi	maṃ + bravi
pemantiādimāhāti	pemaṃ + iti + ādiṃ + āhā + iti
maññidaṃ	maññe + idaṃ
teyevassa	te + eva + assa
devāyatanamivāti	deva + āyatanaṃ + iva + iti
moghamaññantiādinayappavattā	moghaṃ + aññaṃ + iti + ādi + naya + pavattā
nevasekkhanāsekkhoti	na + eva + sekkha + na + asekkho + iti
alamevāti	alaṃ + eva + iti
upaṭṭhānagamanakaṃyevāti	upaṭṭhāna + gamanakaṃ + eva + iti
ekuppādādippakārehi	eka + uppāda + ādi + pakārehi
kathinantiādimāha	kathinaṃ + iti + ādiṃ + āha
lūkhāyaṃ	lūkhā + ayaṃ
rakkhasādīhi	rakkhasa + ādīhi
bhummābhummā	bhumma + abhummā
saggamokkhadaṃ	saggamokkha + daṃ
asāti	asā + iti
vinivijjhanaṭṭhenāti 	vinivijjhana + aṭṭhena + iti
hatthādijhāpanaṭṭhena	hattha + ādi + jhāpana + aṭṭhena
māyāyaṃ	māyā + ayaṃ
vigatavāyanti	vigata + vāyaṃ + iti
ususippaṃ	usu + sippaṃ
dhātidāsiyā	dhātī + dāsiyā
dhātigaṇaṃ	dhāti + gaṇaṃ
dhātiādayo	dhāti + ādayo
dhātikiccaṃ	dhāti + kiccaṃ
dhātisatāni	dhāti + satāni
pañcadhātisatāni	pañca + dhāti + satāni
dhātīritā	dhātu + īritā
cāsā	ca + āsā
vāsipharasusattiārakaṇṭakādīnaṃ	vāsi + pharasu + satti + āra + kaṇṭaka + ādīnaṃ
anīghasumanā	anīgha + sumanā
lūnāvasiṭṭhavisukkhatiladaṇḍakā	lūna + avasiṭṭha + visukkha + tiladaṇḍakā
uṇṇāmayattharaṇo	uṇṇāmaya + attharaṇo
santipaṭissavakammaṃ	santi + paṭissava + kammaṃ
idañcidañcāharathāti	idaṃ + ca + idaṃ + ca + āharatha + iti
cittappavattimattamevāti	citta + pavatti + mattaṃ + eva + iti
yāpesā	yā + api + esā
pāiccevamādīhi	pa + iti + evaṃ + ādīhi
panamhissa	pana + amhi + assa
bhattañcassa	bhattaṃ + ca + assa
mantiādīni	maṃ + iti + ādīni
pesā	api + esā
duppasahajjame	duppasahā + ajja + ime
tividhayaññasampadāya	tividha + yaññasampadāya
santāneva	santāni + eva
asantānīti	asantāni + iti
tyāpareti	te + apare + iti
yovetītipi	yo + aveti + iti + api
hevantissu	hi + evaṃ + iti + assu
suppaṭipannāttha	suppaṭipannā + attha
attapaṭilābhotveva	attapaṭilābho + tu + eva
naṭṭhassatitāya	naṭṭha + sati + tāya
sohanti	so + ahaṃ + iti
nivāsanaṭṭhānaṃ	nivāsana + ṭhānaṃ
yaṃjhānahetu	yaṃ + jhāna + hetu
yaṃjhānakāraṇā	yaṃ + jhāna + kāraṇā
rāgādivūpasamanatthāya	rāga + ādi + vūpasamana + atthāya
adiṭṭhamasutamaparisaṅkitañca	adiṭṭhaṃ + asutaṃ + aparisaṅkitaṃ + ca
setañca	setaṃ + ca
ārāti	ārā + iti
rāgādinirodhatthāya	rāga + ādi + nirodha + atthāya
uṇṇassa	uṇṇā + assa
tvevāti	tu + eva + iti
dīgharattassa	dīgharattaṃ + assa
viriyapaggahaṇatthaṃ	viriya + paggahaṇa + atthaṃ
saccasattappaṭisandhipaccayākārappaṭisaṃyuttaṃ	sacca + satta + paṭisandhi + paccayākāra + paṭisaṃyuttaṃ
sāmhi	sā + amhi
pariyāpannatāvaseneva	pariyāpannatā + vasena + eva
setanti	setaṃ + iti
viagāti	vi + agā + iti
subhanteva	subhaṃ + iti + eva
rūpīsaddopiāvuttiādinayena	rūpī + saddo + api + āvutti + ādi + nayena
yāvakīvañca	yāvakīvaṃ + ca
raññañca	raññaṃ + ca
kaṭṭhattharaṇapaṇṇattharaṇaāsanādīni	kaṭṭha + attharaṇa + paṇṇa + attharaṇa + āsana + ādīni
dukkhamanattāsubhanti	dukkhaṃ + anatta + asubhaṃ + iti
