mistake	correction
kammubinduvihāraṃ	kammabinduvihāraṃ
tadanataraṃ	tadanantaraṃ
evaṃsampadameve	evaṃsampadamevetaṃ
bhūtadevaṭṭonāgasupaṇṇāvaṭṭo	bhūtadevatāvaṭṭonāgasupaṇṇāvaṭṭo
bhūtadevaṭṭonāgasupaṇṇāvaṭṭoti	bhūtadevatāvaṭṭonāgasupaṇṇāvaṭṭoti
nadīñca	nadiñca
pāpupurekkhāro	pāpapurekkhāro
panānananda	panānanda
cittassāhametenti	cittassāhameteti
ussati	ñassati
payyapenti	payapenti
acariya	ācariya
dvattiṃsūcandānaṃ	dvattiṃsacandānaṃ
tuṇhībhū	tuṇhībhūtaṃ
disvāno	disvānotaritaṃ
kālyāṇavācotiādīsu	kalyāṇavācotiādīsu
dvārasālāyānti	dvārasālāyanti
hatthivittako	hatthivitakko
imaṃye	imaṃyeva
māhārāhulovādasuttavaṇṇanā	mahārāhulovādasuttavaṇṇanā
raññikiṭāgirināmo	nāḷakaraññikiṭāgirināmo
paññpemīti	paññapemīti
ruḷahanīyanti	ruḷhanīyanti
tametthaṃ	tamettha
tenupaṅkamiṃsu	tenupasaṅkamiṃsu
tesaṃye	tesaṃyeva
viññāyana	viññāya
citeti	ceteti
payhaṃ	pañhaṃ
vigatūpattilese	vigatūpakkilese
purapuggalānaṃ	parapuggalānaṃ
tūṇhībhūtova	tuṇhībhūtova
rathiyāpī	rathiyāpi
karissatī	karissatīti
vijitāpī	vijitāvī
ssabbattha	sabbattha
atāpī	ātāpī
rokho	kho
sīsyāipotthakesu	sī syā potthakesu
antaradhaṃāyissatīti	antaradhāyissatīti
savibhattaṃ	suvibhattaṃ
paṭipucchitu	paṭipucchitunti
ipotthakesu	potthakesu
medhetha	edhetha
sokaparidevadukkhadomanassupāyāsaā	sokaparidevadukkhadomanassupāyāsā
sukaṭakkaṭānaṃ	sukaṭadukkaṭānaṃ
bahūsū	bahūsu
paccantajanapadāmanussā	paccantajanapadā manussā
bhāvitamāsiṃ	bhāvitamāsiṃsati
cakkaratanaṃu	cakkaratanaṃ
utarāsaṅgaṃ	uttarāsaṅgaṃ
byākarissāmī	byākarissāmi
opayikatarāni	opāyikatarāni
jigiṃ	jigiṃsamāno
kammasu	kammesu
rasaharaṇīyo	rasaharaṇiyo
tenupaṅkamissāmāti	tenupasaṅkamissāmāti
itthīṃ	itthiṃ
ddheḷhakajātā	dheḷhakajātā
hī	hi
ākiñcāññāyatanūpagā	ākiñcaññāyatanūpagā
kalahappavaḍḍhanaākiccakāriṃ	kalahappavaḍḍhanāakiccakāriṃ
assāsapassāssā	assāsapassāsā
vīriyāramme	vīriyārambhe
nti	paṭipucchitunti
adukkhamasuṃ	adukkhamasukhaṃ
jarāmaraṇasamudaṃ	jarāmaraṇasamudayaṃ
nirujjhāmānā	nirujjhamānā
diyaḍhḍasataṃ	diyaḍḍhasataṃ
candanikāye	candanikāyaṃ
kappeyāma	kappeyyāma
ākaṅkeyya	ākaṅkheyya
marahatīti	arahatīti
natatthevantaradhāyathāti	tatthevantaradhāyathāti
upapajjeyanti	upapajjeyyanti
upapajjeya	upapajjeyya
jāname	jānameva
pabbajāyāti	pabbajjāyāti
pisuṇāvāco	pisuṇavāco
pharusāvāco	pharusavāco
ettāvattā	ettāvatā
abhiṅkharitvā	abhisaṅkharitvā
adīnavañca	ādīnavañca
māyākatame	māyākatametaṃ
pacchimasopānakaḷevarāḥ	pacchimasopānakaḷevarā
ajjheneḥ	ajjhene
vimuccitthaḥ	vimuccittha
acikkhissāmi	ācikkhissāmi
sanatā	nijigiṃsanatā
tatre	tatreva
ta	tatra
vuṭṭe	vuṭṭhe
kusalāyātikā	kusalāyatikā
vedayya	vadeyya
parihiṃ	parihiṃsatthāya
ayokhilaṃ	ayokhīlaṃ
majjheurasmiṃ	majjhe urasmiṃ
dhammānaṃtve	dhammānaṃtveva
sammākammantī	sammākammanto
sāmīcikammacīvarapiṇḍapātasenāsanagilā	sāmīcikammacīvarapiṇḍapātasenāsana
nappaccayabhesajjaparikkhārānuppadānena	gilānappaccayabhesajjaparikkhārānuppadānena
cīvarapiṇḍapātasenāsanagilā	cīvarapiṇḍapātasenāsana
bahunojanassa	bahuno janassa
samuccā	sammuccā
viyaṃ	piyaṃ
vāmakase	kacchevāmakase
gaḷeyyasi	gaḷeyyāsi
tatthevantaradhāyithāti	tatthevantaradhāyitthāti
purissa	purisassa
uppajeyya	uppajjeyya
bhikkhuhi	bhikkhūhi
paṭhamajhāna	paṭhamajjhāna
dutiyajhāna	dutiyajjhāna
tatiyajhāna	tatiyajjhāna
abhibhuto	abhibhūto
nijanasambādhāni	nijjanasambādhāni
anvāvisiṭṭhā	anvāviṭṭhā
vekacaraṃ	sīhaṃvekacaraṃ
vinivaṭṭhetvā	vinivaṭṭetvā
āvedhita	āveṭhita
dandapañño	dandhapañño
parivattetitvā	parivattitvā
samajjāpetvā	sammajjāpetvā
uppaddavāpi	upaddavāpi
uppaddavaṃ	upaddavaṃ
uppaddavā	upaddavā
suddinna	sudinna
arocesuṃ	ārocesuṃ
sarāmiti	sarāmīti
amanassubhatobyañjanakaṃ	amanussubhatobyañjanakaṃ
brāhmacārino	brahmacārino
dukkaṭasa	dukkaṭassa
orocesuṃ	ārocesuṃ
anāpati	anāpatti
voropetti	voropeti
gihīṃ	gihiṃ
tīkārehi	tīhākārehi
vatthuni	vatthūni
muccatti	muccati
mocanāmippāyassa	mocanādhippāyassa
upādāyaṃ	upādāya
vipariṇattaṃ	vipariṇataṃ
duṭṭhallāduṭṭhullaṃ	duṭṭhullāduṭṭhullaṃ
bhuñjithā	bhuñjittha
bhuñjithāti	bhuñjitthāti
pituraakhatañca	piturakkhitañca
vimaṃsā	vīmaṃsā
vimaṃsāti	vīmaṃsāti
dukkāṭanaṃ	dukkaṭānaṃ
dukkāṭānaṃ	dukkaṭānaṃ
bhikkhuve	bhikkhave
brahmacariyācāveyyanti	brahmacariyā cāveyyanti
anācaraṃ	anācāraṃ
sañcissantipi	siñcissantipi
rahonāma	raho nāma
tene	tena
hotī	hotīti
sajjasīti	sajjesīti
bhumattharaṇaṃ	bhūmattharaṇaṃ
ujjhāyyanti	ujjhāyanti
pañcakkhatuṃ	pañcakkhattuṃ
uppajjayyuṃ	uppajjeyyuṃ
pilindivaccho	pilindavaccho
bhessajjānīti	bhesajjānīti
añātakasaññī	aññātakasaññī
parivattabbaṃ	parivatthabbaṃ
sambahūlehi	sambahulehi
cā	cāti
mātāpituraakhatañca	mātāpiturakkhitañca
akāsepi	ākāsepi
ukaṭṭhaṃ	ukkaṭṭhaṃ
viciccathāyye	viviccathāyye
sakkacaṃ	sakkaccaṃ
abhinippajjati	abhinipajjati
anisaṃsaṃ	ānisaṃsaṃ
yaṃnnūnāhaṃ	yaṃnūnāhaṃ
aparipācitte	aparipācite
ārācesuṃ	ārocesuṃ
asammattaṃ	asammataṃ
bojhaṅge	bojjhaṅge
coḷabhiti	coḷabhisi
gaddhabādhipubbane	gaddhabādhipubbena
idisesu	īdisesu
ovandantīti	ovadantīti
ovandatīti	ovadatīti
pācattiyanti	pācittiyanti
pacittiyassa	pācittiyassa
pācittiyyanti	pācittiyanti
rajjanīyāni	rajanīyāni
rittahattaṃ	rittahatthaṃ
saṅghādisessa	saṅghādisesa
ttamano	cattamano
vemitako	vematiko
ekaccāsassatikā	ekaccaasassatikā
yassāyasmāto	yassāyasmato
ādikammissāti	ādikammikassāti
pavāressatī	pavāressatīti
anāpattiādiyitvā	anāpatti ādiyitvā
anāthapiṇḍakassa	anāthapiṇḍikassa
tiracchāgatamanussaviggahena	tiracchānagatamanussaviggahena
dhammikonāma	dhammiko nāma
dutiyasikkhamāna	dutiyasikkhamānanavuṭṭhāpanasikkhāpada
pavattetti	pavatteti
samaṇabrāhmaṇākammavādā	samaṇabrāhmaṇā kammavādā
khīṇājāti	khīṇā jāti
sasandanti	saṃsandanti
dhammānuppajjamānā	dhammā nuppajjamānā
kūlūpako	kulūpako
etthakesu	ettakesu
anusāsanīnti	anusāsaninti
paṃsukuliko	paṃsukūliko
anupubbavihārasamāpattinaṃ	anupubbavihārasamāpattīnaṃ
tariyacatutthasuttesu	tatiyacatutthasuttesu
yātappaṃ	ātappaṃ
anajjhosā	anajjhosāya
anabhisaṅkhārañca	anabhisaṅkhacca
ghositarāme	ghositārāme
desessāmī	desessāmi
catārome	cattārome
anigatarāgassa	avigatarāgassa
ākusalā	akusalā
bhikkhunābhinandati	bhikkhu nābhinandati
passatāmi	passatāmiva
ñhi	ñātañhi
aniccatāye	aniccatāyeva
dūkkhassāti	dukkhassāti
pubbanimmittaṃ	pubbanimittaṃ
vepullāyaṃ	vepullāya
upekkilesā	upakkilesā
bojjhaṅgasaṃyutassa	bojjhaṅgasaṃyuttassa
asaṃvadamānā	saṃvadamānā
sakuṇagdhi	sakuṇagghi
aṭṭhaṅkiko	aṭṭhaṅgiko
maṇabrāhmaṇiyā	sassamaṇabrāhmaṇiyā
sotapanno	sotāpanno
āyatanānī	āyatanānītissa
manubhoti	anubhoti
kāgarāgābhinivesavinibandhapaligedhapariyuṭṭhānajjhosānaṃ	kāmarāgābhinivesavinibandhapaligedhapariyuṭṭhānajjhosānaṃ
dhammānussārī	dhammānusārī
sammāsaṅkapo	sammāsaṅkappo
nikāmalāmī	nikāmalābhī
pahanāya	pahānāya
abhiviniye	abhivinaye
brāhmalokāpi	brahmalokāpi
pahātabbot	pahātabboti
bbhavikehi	ponobbhavikehi
gihisāmicīti	gihisāmīcīti
dubbaṇo	dubbaṇṇo
viññā	viññāya
pono	ponobhavikehi
attavādī	atthavādī
akaṅkhati	ākaṅkhati
ḍaṃsamakasavātātapasarīsa	ḍaṃsamakasavātātapasarīsapasamphassānaṃ
pasamphassānaṃ	ḍaṃsamakasavātātapasarīsapasamphassānaṃ
dupañño	duppañño
vācimanuvācenti	vācitamanuvācenti
suṇohhi	suṇohi
bhavissatī	bhavissatīti
saṃvijjatī	saṃvijjati
mahātūriya	mahātūriyatāḷitavāditena
tāḷitavāditena	mahātūriyatāḷitavāditena
māgataṃ	nibbanamāgataṃ
maccagā	sibbinimaccagāti
maccagāti	sibbinimaccagāti
bhijāti	abhijāti
sandharitun	sandharituṃ
nandamātena	nandamātuyā
atthahitāya	attahitāya
phalagaṇḍassa	palagaṇḍassa
phalagaṇḍantevāsikassa	palagaṇḍantevāsikassa
paribhujjeyyāti	paribhuñjeyyāti
anantarasuttadveye	anantarasuttadvaye
yebhuyyassikā	yebhuyyasikā
tassapāpiyyassikā	tassapāpiyasikā
di	dī
āghātāni	āghātā
silāyupo	silāyūpo
kāmehī	kāmehi
vittharena	vitthārena
nisaṃsoti	ānisaṃsoti
ākiñcaññāyattane	ākiñcaññāyatane
vijjayāti	vijjāyāti
jhānāvuttā	jhānā vuttā
paṭijjitabbanti	paṭipajjitabbanti
māgamma	anokamāgamma
abhisamparāyañcā	abhisamparāyañcāti
puttam	puttaṃ
pātthakesu	pāṭhakesu
manassesu	manussesu
rahantaṃ	arahantaṃ
paribbājiko	paribbājako
vuttānīti	vutthānīti
bhibhūtena	thinamiddhābhibhūtena
bhikkhūnīhi	bhikkhunīhi
abhikkataṃ	abhikkantaṃ
mahāsammuddassa	mahāsamuddassa
pattayogakhemā	pattayogakkhemā
yogakhemā	yogakkhemā
yogakhemakāmā	yogakkhemakāmā
paricāressantī	paricāressantīti
diṭṭā	diṭṭhā
dhipātā	pajjotamivādhipātā
taṇhākhayo	taṇhākkhayo
cundassānanda	cundassa ānanda
samutejetvā	samuttejetvā
pabbatoḥ	pabbato
savidhātaṃ	savighātaṃ
anirākatamajjhānānaṃ	anirākatajjhānaṃ
bando	bandho
micā	micchā
paccuppanaṃ	paccuppannaṃ
sabbatha	sabbattha
hujjanaṃ	bahujjanaṃ
abhinivejjetvā	abhinivajjetvā
araññeḥ	araññe
sañīmīti	saūmīti
bhijjhā	abhijjhā
aṭakathāya	aṭṭhakathāya
vicikiccā	vicikicchā
abhisambuddhoḥ	abhisambuddho
abhisambuddhāḥ	abhisambuddhā
upaparikkhayā	upaparikkhāya
gabbhīrapaññaṃ	gambhīrapaññaṃ
maṃcchamaṃsānānāsakattaṃ	macchamaṃsānānāsakattaṃ
sapphasso	samphasso
vitatāvane	vitatā vane
nacirasse	nacirasseva
aggipāricāriyā	aggiparicariyā
parinabbutoti	parinibbutoti
yannūnnāhaṃ	yannūnāhaṃ
desati	deseti
apuripuṇṇehi	aparipuṇṇehi
panāpasmā	panāyasmā
aṭṭhakathāsaṃvaṇanā	aṭṭhakathāsaṃvaṇṇanā
ttānaṃ	sattānaṃ
acirappakkantassa	acirapakkantassa
nāmamevā	nāmamevāvasissati
nāriṃsu	nātariṃsu
mariyehi	ariyehi
sambhireva	sabbhireva
laddāna	laddhāna
tīnohaṃ	hīnohaṃ
cattāsīla	cattālīsa
upajjitvā	uppajjitvā
nirāmagataddasā	niyāmagataddasā
patisso	upatisso
samacchidagatta	samucchidagatta
paveccasi	pavecchasi
purisapātabahulamhi	dhanikapurisapātabahulamhi
desante	desente
vikulakaṃ	vikūlakaṃ
kāmabhogina	kāmabhoginamaggo
bhagavate	bhavagate
maraṇabyādhihi	maraṇabyādhīhi
tātabhinikkha	tātabhinikkhamissaṃ
pitara	pitaramanīkaratto
manīkaratto	pitaramanīkaratto
āṇādhanamissa	āṇādhanamissariyaṃ
riyaṃ	āṇādhanamissariyaṃ
pheṇapiṇḍopa	pheṇapiṇḍopamassa
aparise+saṁ	aparisesaṃ
satthataṃ	santhataṃ
tiṇṇavicchikicchā	tiṇṇavicikicchā
sāmaññe	sāmaññeva
okkanditvā	okkhanditvā 
idappaccayatāpaaccasamuppādo	idappaccayatāpaṭiccasamuppādo
apagatamacchikaṇḍakaṃ	apagatamakkhikaṇḍakaṃ
mañjaṭṭhiyā	mañjeṭṭhiyā
setādisī	yassāsetādisī
vācāpaṭisandhāraṃ	vācāpaṭisanthāraṃ
paṭisantāraṃ	paṭisanthāraṃ
vācāpaṭisandhāramattampi	vācāpaṭisanthāramattampi
āmisappaṭisandhārena	āmisappaṭisanthārena
paṭisandhāro	paṭisanthāro
appaṭisandhāro	appaṭisanthāro
dhammapaṭisandhārakathāyaṃ	dhammapaṭisanthārakathāyaṃ 
dhammapaṭisandhāro	dhammapaṭisanthāro
paṭisandhārakusalataṃ	paṭisanthārakusalataṃ
paṭisandhārakusalo	paṭisanthārakusalo
sapaṭṭhitaṃ	sūpaṭṭhitaṃ
pavārayeti	pavārayati
uppaṭṭhapetvā	upaṭṭhapetvā
opaguyhanti	opavayhanti
viriyamhinā	viriyavāminā
rupārūpabhave	rūpārūpabhave
dusamuṭṭhāpayaṃ	dussamuṭṭhāpayaṃ
dusamuṭṭhāpayanti	dussamuṭṭhāpayanti
paṇṇativajjaṃ	paṇṇattivajjaṃ
yācatī	yācatīti
ubhatobyūḷanti	ubhatobyūḷhanti
yiṭṭhakāmassa	yiṭṭhukāmassa
parahiṃsatthāya	barihisatthāya
upaṇḍeti	uppaṇḍeti
sūdāni	sūdā hi
apasādikena	apāsādikena
dukkhasamphasoti	dukkhasamphassoti
sārameyaṃ	sārameyyaṃ
majjanhike	majjhanhike
janappadatthāvariyappatto	janapadatthāvariyappatto
hatthiassadīnaṃ	hatthiassādīnaṃ
lalati	laḷati
tiretīti	tīretīti
nidiṭṭhāti	niddiṭṭhāti
sovattiko	sovatthiko
nissapaṭippassaddhikathā	nissayapaṭippassaddhikathā
pajjhāyena	upajjhāyena
dukkaṭassā	dukkaṭassāti
kātu	kātunti
pakkhagaṇanamattamampime	pakkhagaṇanamattampime
gaṇhiṃsuṃ	gaṇhiṃsu
ummattakasammuttiṃ	ummattakasammutiṃ
jānati	jānāti
sattāhakaraṇīyānujānatā	sattāhakaraṇīyānujānanā
vassacchedassati	vassacchedassāti
sallavimhā	sallapimhā
aññarasmiṃ	aññatarasmiṃ
sīmottantikapeyyālaṃ	sīmokkantikapeyyālaṃ
sabbamañjeṭṭhikā	sabbamañjiṭṭhikā
sokasuttena	soṇasuttena
pavatthe	pavatte
amanuppattaṃ	anuppattaṃ
senesikāni	senesitāni
paribhuñjeya	paribhuñjeyya
ruḷaho	ruḷho
anekapariyānena	anekapariyāyena
ucchīnnamūlā	ucchinnamūlā
meṇḍakagahapativattha	meṇḍakagahapativatthu
upapiṃ	upapiṃsanaṃ
sanī	upapiṃsanī
anā	anāpattidiṭṭhi
pattidiṭṭhi	anāpattidiṭṭhi
upaṅkamitvā	upasaṅkamitvā
appaṭinissage	appaṭinissagge
manattārahena	mānattārahena
ujhāyanti	ujjhāyanti
aññattaro	aññataro
purivuttho	parivuttho
aparāāpattīn	aparāāpattīnaṃ
gahitāgahituñca	gahitāgahitañca
āyattiṃ	āyatiṃ
ācaravipattiyā	ācāravipattiyā
pañcavīsattikā	pañcavīsatikā
vamaññanto	avamaññanto
tirittamaṃsaṃ	atirittamaṃsaṃ
khiyantānaṃ	khiyyantānaṃ
assesi	assosi
ubbhegauttāsabhayāpanūdano	ubbegauttāsabhayāpanūdano
majjappamādaṭṭhānānuyoge	surāmerayamajjappamādaṭṭhānānuyoge
cariyānuyoge	vikālavisikhācariyānuyoge
hevamato	hemavato
saṅgitiyapañcakaṃ	saṅgītiyapañcakaṃ
middhī	atthassamiddhī
gilānapaccayabhesajja	gilānapaccayabhesajjaparikkhāro
pathamajjhānādīnaṃ	paṭhamajjhānādīnaṃ
pathamabhāṇavāro	paṭhamabhāṇavāro
aparise	aparisesaṃ
vokkama	vokkamma
ḍaṃsamakasavātātapasarīṃsapa	ḍaṃsamakasavātātapasarīṃsapasamphassānaṃ
tittakālābuāmakacchinno	tittakālābu āmakacchinno
abhivādanapaccuṭṭhānaañjalikammasāmīcikammacīvarapiṇḍapātasenāsanagilā	abhivādanapaccuṭṭhānaañjalikammasāmīcikammacīvarapiṇḍapātasenāsanagilanappaccayabhesajjaparikkhārānuppadānena
orācesuṃ	ārocesuṃ
puggallena	puggalena
chādenamattenapi	chādanamattenapi
bhaṇḍikāḷapanamattenapi	bhaṇḍikāṭṭhapanamattenapi
parivutto	parivuto
aduṭṭhulā	aduṭṭhullā
ittivu	itivu
pānīyenipi	pānīyenapi
piṇḍipāto	piṇḍapāto
pariphositvā	paripphositvā
pamajitvā	pamajjitvā
suṃsavutokkhittacakkhu	susaṃvutokkhittacakkhu
yākāci	yā kāci
sannipūtitvā	sannipatitvā
arahataphalasacchikiriyāya	arahattaphalasacchikiriyāya
saṃviñjati	saṃvijjati
setaṭṭikā	setaṭṭhikā
sakāvāsā	sakāsāvā
asammukhāppaṭipucchāp	asammukhāppaṭipucchāppaṭiññāya
aparāāpattīna	aparāāpattīnaṃ
paribhijjiti	paribhijjati
visativassikampi	vīsativassikampi
bhaṇḍikāḷapanamattena	bhaṇḍikāṭṭhapanamattena
visativassikaṃ	vīsativassikaṃ
tāvasiṃsabhavaneti	tāvatiṃsabhavaneti
manveti	sukhamanveti
akaniṭṭhabhāvanā	akaniṭṭhabhavanā
svākhāte	svākkhāte
pācinavaṃsamigadāye	pācīnavaṃsamigadāye
hatthīnīhi	hatthinīhi
uppattitvā	uppatitvā
sahassacakkavāḷadevatāhi	dasasahassacakkavāḷadevatāhi
dasamāsacceyena	dasamāsaccayena
sampattaparibhāyapi	sampattaparisāyapi
saradatāpasassaṃ	saradatāpasassa
samajjhissati	samijjhissati
brahmarūpivaṇṇaṃ	brahmarūpivaṇṇaṃ
ukkaṇṭhitomīti	ukkaṇṭhitomhīti
sāḷasaṅgulikaṇṭakaṃ	soḷasaṅgulikaṇṭakaṃ
paggharaṇataṃ	paggharantaṃ
bhikkhadānaṃ	bhikkhādānaṃ
cundasūkaritassa	cundasūkarikassa
paṭikucchitvā	paṭikujjitvā
nipphalikā	nipphalitā
kappanto	kappento
bhikkhūsahassāni	bhikkhusahassāni
appampī	appampīceti
